Alophoixus finschii	NaN
Anthocephala floriceps	VU
Aramides cajaneus	LC
Arremon flavirostris	LC
Canis lupus	LC
Canis rufus	CR
Catharus dryas	LC
Celeus grammicus	NaN
Celeus undatus	LC
Cerasophila thompsoni	NaN
Chlorocharis emiliae	NaN
Claravis geoffroyi	NaN
Claravis mondetoura	NaN
Cypsiurus parvus	LC
Eclectus roratus	LC
Fake taxon	NaN
Gallinula angulata	NaN
Gallinula melanops	NaN
Geophaps ferruginea	NaN
Heliangelus zusii	NaN
Hylatomus galeatus	NaN
Macropygia magna	LC
Malurus lamberti	LC
Megascops asio	LC
Megascops cooperi	LC
Microptilotis gracilis	LC
Myiomela albiventris	NaN
Myiomela major	NaN
Nothura chacoensis	NaN
Nothura maculosa	LC
Nyctibius bracteatus	NaN
Ortalis guttata	LC
Ortalis squamata	LC
Otus scops	LC
Pelecanoides georgicus	LC
Petrochelidon fuliginosa	NaN
Phaethornis bourcieri	LC
Phylloscopus presbytes	LC
Poecile montanus	LC
Pycnonotus cyaniventris	NaN
Pycnonotus dispar	NaN
Pycnonotus erythropthalmos	NaN
Pycnonotus flaviventris	NaN
Pycnonotus gularis	NaN
Pycnonotus hualon	NaN
Pycnonotus leucogrammicus	NaN
Pycnonotus melanicterus	NaN
Pycnonotus montis	NaN
Pycnonotus simplex	LC
Pycnonotus squamatus	NaN
Pycnonotus striatus	NaN
Pyrrhura melanura	LC
Remiz macronyx	NaN
Remiz pendulinus	LC
Schoutedenapus myoptilus	LC
Schoutedenapus schoutedeni	NaN
Suiriri affinis	NaN
Thapsinillas affinis	NaN
Thapsinillas aurea	NaN
Thapsinillas chloris	NaN
Thapsinillas harterti	NaN
Thapsinillas longirostris	NaN
Thapsinillas lucasi	NaN
Thapsinillas mysticalis	NaN
Thapsinillas platenae	NaN
Trochalopteron cachinnans	NaN
Trochalopteron fairbanki	NaN
Trochalopteron jerdoni	NaN
Trochalopteron meridionale	NaN
Turacoena manadensis	LC
Vireo olivaceus	LC
Zoothera aurea	LC
Zoothera dauma	LC
Zosterops citrinella	LC
Zosterops everetti	LC
Zosterops japonicus	LC
Zosterops montanus	NaN
Zosterops palpebrosus	LC
Zosterops salvadorii	NaN
