species	current_status
Abditomys latidens	DD
Abeomelomys sevia	LC
Abrawayaomys chebezi	DD
Abrawayaomys ruschii	LC
Abrocoma bennettii	LC
Abrocoma boliviensis	CR
Abrocoma budini	DD
Abrocoma cinerea	LC
Abrocoma famatina	DD
Abrocoma shistacea	LC
Abrocoma uspallata	DD
Abrocoma vaccarum	DD
Abrothrix andinus	LC
Abrothrix illutea	LC
Abrothrix jelskii	LC
Abrothrix lanosus	LC
Abrothrix longipilis	LC
Abrothrix olivaceus	LC
Abrothrix sanborni	NT
Acerodon celebensis	VU
Acerodon humilis	EN
Acerodon jubatus	EN
Acerodon leucotis	VU
Acerodon mackloti	VU
Acinonyx jubatus	VU
Acomys airensis	LC
Acomys cahirinus	LC
Acomys cilicicus	DD
Acomys cineraceus	LC
Acomys dimidiatus	LC
Acomys ignitus	LC
Acomys johannis	LC
Acomys kempi	LC
Acomys louisae	LC
Acomys minous	DD
Acomys mullah	LC
Acomys muzei	LC
Acomys nesiotes	DD
Acomys ngurui	LC
Acomys percivali	LC
Acomys russatus	LC
Acomys selousi	LC
Acomys seurati	LC
Acomys spinosissimus	LC
Acomys wilsoni	LC
Aconaemys fuscus	LC
Aconaemys porteri	DD
Aconaemys sagei	DD
Acrobates pygmaeus	LC
Addax nasomaculatus	CR
Aegialomys galapagoensis	VU
Aegialomys xanthaeolus	LC
Aepeomys lugens	LC
Aepeomys reigi	VU
Aepyceros melampus	LC
Aepyprymnus rufescens	LC
Aeretes melanopterus	NT
Aeromys tephromelas	DD
Aeromys thomasi	LC
Aethalops aequalis	LC
Aethalops alecto	LC
Aethomys bocagei	LC
Aethomys chrysophilus	LC
Aethomys hindei	LC
Aethomys ineptus	LC
Aethomys kaiseri	LC
Aethomys nyikae	LC
Aethomys silindensis	DD
Aethomys stannarius	DD
Aethomys thomasi	LC
Ailuropoda melanoleuca	VU
Ailurops melanotis	CR
Ailurops ursinus	VU
Ailurus fulgens	EN
Akodon aerosus	LC
Akodon affinis	LC
Akodon albiventer	LC
Akodon azarae	LC
Akodon boliviensis	LC
Akodon budini	LC
Akodon caenosus	DD
Akodon cursor	LC
Akodon dayi	LC
Akodon dolores	LC
Akodon fumeus	LC
Akodon iniscatus	LC
Akodon juninensis	LC
Akodon kofordi	LC
Akodon lindberghi	DD
Akodon lutescens	LC
Akodon mimus	LC
Akodon molinae	LC
Akodon mollis	LC
Akodon montensis	LC
Akodon mystax	DD
Akodon orophilus	LC
Akodon paranaensis	LC
Akodon pervalens	DD
Akodon philipmyersi	DD
Akodon polopi	LC
Akodon reigi	LC
Akodon sanctipaulensis	DD
Akodon serrensis	LC
Akodon siberiae	NT
Akodon simulator	LC
Akodon spegazzinii	LC
Akodon subfuscus	LC
Akodon surdus	VU
Akodon sylvanus	LC
Akodon toba	LC
Akodon torques	LC
Akodon varius	DD
Alcelaphus buselaphus	LC
Alces alces	LC
Alionycteris paucidentata	LC
Allactaga balikunica	LC
Allactaga bullata	LC
Allactaga elater	LC
Allactaga euphratica	NT
Allactaga firouzi	DD
Allactaga hotsoni	LC
Allactaga major	LC
Allactaga severtzovi	LC
Allactaga sibirica	LC
Allactaga tetradactyla	DD
Allactaga vinogradovi	NT
Allactaga williamsi	LC
Allactodipus bobrinskii	LC
Allenopithecus nigroviridis	LC
Allocebus trichotis	VU
Allochrocebus lhoesti	VU
Allochrocebus preussi	EN
Allochrocebus solatus	NT
Allocricetulus curtatus	LC
Allocricetulus eversmanni	LC
Alouatta arctoidea	LC
Alouatta belzebul	VU
Alouatta caraya	LC
Alouatta discolor	VU
Alouatta guariba	LC
Alouatta macconnelli	LC
Alouatta nigerrima	LC
Alouatta palliata	LC
Alouatta pigra	EN
Alouatta sara	LC
Alouatta ululata	EN
Alticola albicaudus	DD
Alticola argentatus	LC
Alticola barakshin	LC
Alticola lemminus	LC
Alticola macrotis	LC
Alticola montosa	VU
Alticola olchonensis	EN
Alticola roylei	NT
Alticola semicanus	LC
Alticola stoliczkanus	LC
Alticola strelzowi	LC
Alticola tuvinicus	LC
Amblysomus corriae	NT
Amblysomus hottentotus	LC
Amblysomus marleyi	EN
Amblysomus robustus	VU
Amblysomus septentrionalis	NT
Ametrida centurio	LC
Ammodillus imbellis	DD
Ammodorcas clarkei	VU
Ammospermophilus harrisii	LC
Ammospermophilus interpres	LC
Ammospermophilus leucurus	LC
Ammospermophilus nelsoni	EN
Ammotragus lervia	VU
Amorphochilus schnablii	VU
Amphinectomys savamis	DD
Anathana ellioti	LC
Andalgalomys olrogi	LC
Andalgalomys pearsoni	LC
Andinomys edax	LC
Anisomys imitator	LC
Anomalurus beecrofti	LC
Anomalurus derbianus	LC
Anomalurus pelii	DD
Anomalurus pusillus	LC
Anonymomys mindorensis	DD
Anotomys leander	EN
Anoura aequatoris	LC
Anoura cadenai	DD
Anoura caudifer	LC
Anoura cultrata	LC
Anoura fistulata	DD
Anoura geoffroyi	LC
Anoura latidens	LC
Anoura luismanueli	LC
Anoura peruana	LC
Anourosorex assamensis	LC
Anourosorex schmidi	DD
Anourosorex squamipes	LC
Anourosorex yamashinai	LC
Antechinomys laniger	LC
Antechinus adustus	LC
Antechinus agilis	LC
Antechinus bellus	VU
Antechinus flavipes	LC
Antechinus godmani	LC
Antechinus leo	LC
Antechinus minimus	LC
Antechinus stuartii	LC
Antechinus subtropicus	LC
Antechinus swainsonii	LC
Anthops ornatus	DD
Antidorcas marsupialis	LC
Antilocapra americana	LC
Antilope cervicapra	LC
Antrozous pallidus	LC
Aonyx capensis	NT
Aonyx cinereus	VU
Aonyx congicus	NT
Aotus azarae	LC
Aotus brumbacki	VU
Aotus griseimembra	VU
Aotus jorgehernandezi	DD
Aotus lemurinus	VU
Aotus miconax	EN
Aotus nancymaae	VU
Aotus nigriceps	LC
Aotus trivirgatus	LC
Aotus vociferans	LC
Aotus zonalis	DD
Aplodontia rufa	LC
Apodemus agrarius	LC
Apodemus alpicola	LC
Apodemus argenteus	LC
Apodemus avicennicus	DD
Apodemus chevrieri	LC
Apodemus draco	LC
Apodemus epimelas	LC
Apodemus flavicollis	LC
Apodemus gurkha	LC
Apodemus hyrcanicus	NT
Apodemus latronum	LC
Apodemus mystacinus	LC
Apodemus pallipes	LC
Apodemus peninsulae	LC
Apodemus ponticus	LC
Apodemus rusiges	LC
Apodemus semotus	LC
Apodemus speciosus	LC
Apodemus sylvaticus	LC
Apodemus uralensis	LC
Apodemus witherbyi	LC
Apomys abrae	LC
Apomys aurorae	LC
Apomys banahao	LC
Apomys brownorum	DD
Apomys camiguinensis	VU
Apomys datae	LC
Apomys gracilirostris	LC
Apomys hylocetes	LC
Apomys insignis	LC
Apomys iridensis	LC
Apomys littoralis	DD
Apomys lubangensis	LC
Apomys magnus	LC
Apomys microdon	LC
Apomys minganensis	LC
Apomys musculus	LC
Apomys sacobianus	LC
Apomys sierrae	LC
Apomys zambalensis	LC
Aproteles bulmerae	CR
Arabitragus jayakari	EN
Arborimus albipes	LC
Arborimus longicaudus	NT
Arborimus pomo	NT
Archboldomys luzonensis	VU
Archboldomys maximus	DD
Arctictis binturong	VU
Arctocebus aureus	LC
Arctocebus calabarensis	NT
Arctocephalus australis	LC
Arctocephalus australis	LC
Arctocephalus forsteri	LC
Arctocephalus galapagoensis	EN
Arctocephalus gazella	LC
Arctocephalus philippii	LC
Arctocephalus pusillus	LC
Arctocephalus townsendi	LC
Arctocephalus tropicalis	LC
Arctogalidia trivirgata	LC
Arctonyx albogularis	LC
Arctonyx collaris	VU
Arctonyx hoevenii	LC
Ardops nichollsi	LC
Arielulus aureocollaris	LC
Arielulus circumdatus	LC
Arielulus cuprosus	VU
Arielulus societatis	VU
Arielulus torquatus	LC
Ariteus flavescens	LC
Artibeus aequatorialis	LC
Artibeus amplus	LC
Artibeus concolor	LC
Artibeus fimbriatus	LC
Artibeus fraterculus	LC
Artibeus hirsutus	LC
Artibeus inopinatus	DD
Artibeus jamaicensis	LC
Artibeus lituratus	LC
Artibeus obscurus	LC
Artibeus planirostris	LC
Artibeus schwartzi	DD
Arvicanthis abyssinicus	LC
Arvicanthis ansorgei	LC
Arvicanthis blicki	NT
Arvicanthis nairobae	LC
Arvicanthis neumanni	LC
Arvicanthis niloticus	LC
Arvicanthis rufinus	LC
Arvicola amphibius	LC
Arvicola sapidus	VU
Arvicola scherman	LC
Asellia arabica	DD
Asellia italosomalica	DD
Asellia patrizii	LC
Asellia tridens	LC
Aselliscus stoliczkanus	LC
Aselliscus tricuspidatus	LC
Atelerix albiventris	LC
Atelerix algirus	LC
Atelerix frontalis	LC
Atelerix sclateri	LC
Ateles belzebuth	EN
Ateles chamek	EN
Ateles fusciceps	CR
Ateles geoffroyi	EN
Ateles hybridus	CR
Ateles marginatus	EN
Ateles paniscus	VU
Atelocynus microtis	NT
Atherurus africanus	LC
Atherurus macrourus	LC
Atilax paludinosus	LC
Atlantoxerus getulus	LC
Atopogale cubana	EN
Auliscomys boliviensis	LC
Auliscomys pictus	LC
Auliscomys sublimis	LC
Austronomus australis	LC
Austronomus kuboriensis	LC
Avahi betsileo	EN
Avahi cleesei	EN
Avahi laniger	VU
Avahi meridionalis	EN
Avahi mooreorum	EN
Avahi occidentalis	EN
Avahi peyrierasi	VU
Avahi ramanantsoavanai	VU
Avahi unicolor	EN
Axis axis	LC
Axis calamianensis	EN
Axis kuhlii	CR
Axis porcinus	EN
Babyrousa babyrussa	VU
Babyrousa celebensis	VU
Babyrousa togeanensis	EN
Baeodon alleni	LC
Baeodon gracilis	LC
Baiomys musculus	LC
Baiomys taylori	LC
Baiyankamys habbema	DD
Baiyankamys shawmayeri	LC
Balaena mysticetus	LC
Balaena mysticetus	LC
Balaena mysticetus	LC
Balaena mysticetus	LC
Balaenoptera acutorostrata	LC
Balaenoptera bonaerensis	NT
Balaenoptera borealis	EN
Balaenoptera edeni	LC
Balaenoptera edeni	LC
Balaenoptera musculus	EN
Balaenoptera omurai	DD
Balaenoptera physalus	VU
Balaenoptera physalus	VU
Balantiopteryx infusca	VU
Balantiopteryx io	VU
Balantiopteryx plicata	LC
Balionycteris maculata	LC
Bandicota bengalensis	LC
Bandicota indica	LC
Bandicota savilei	LC
Barbastella barbastellus	NT
Barbastella leucomelas	LC
Bassaricyon alleni	LC
Bassaricyon gabbii	LC
Bassaricyon medius	LC
Bassaricyon neblina	NT
Bassariscus astutus	LC
Bassariscus sumichrasti	LC
Bathyergus janetta	LC
Bathyergus suillus	LC
Batomys dentatus	DD
Batomys granti	LC
Batomys hamiguitan	DD
Batomys russatus	EN
Batomys salomonseni	LC
Batomys uragon	LC
Bauerus dubiaquercus	NT
Bdeogale crassicauda	LC
Bdeogale jacksoni	NT
Bdeogale nigripes	LC
Bdeogale omnivora	VU
Beamys hindei	LC
Beatragus hunteri	CR
Belomys pearsonii	DD
Berardius arnuxii	DD
Berardius bairdii	DD
Berylmys berdmorei	LC
Berylmys bowersi	LC
Berylmys mackenziei	DD
Berylmys manipulus	DD
Bettongia gaimardi	NT
Bettongia lesueur	NT
Bettongia penicillata	CR
Bettongia tropica	EN
Bibimys chacoensis	LC
Bibimys labiosus	LC
Bibimys torresi	VU
Bison bison	NT
Bison bonasus	VU
Biswamoyopterus biswasi	CR
Biswamoyopterus laoensis	DD
Blanfordimys afghanus	LC
Blanfordimys bucharensis	LC
Blarina brevicauda	LC
Blarina carolinensis	LC
Blarina hylophaga	LC
Blarinella griselda	LC
Blarinella quadraticauda	NT
Blarinella wardi	LC
Blarinomys breviceps	LC
Blastocerus dichotomus	VU
Bos gaurus	VU
Bos javanicus	EN
Bos mutus	VU
Bos sauveli	CR
Boselaphus tragocamelus	LC
Brachiones przewalskii	LC
Brachylagus idahoensis	LC
Brachyphylla cavernarum	LC
Brachyphylla nana	LC
Brachytarsomys albicauda	LC
Brachytarsomys villosa	VU
Brachyteles arachnoides	CR
Brachyteles hypoxanthus	CR
Brachyuromys betsileoensis	LC
Brachyuromys ramirohitra	LC
Bradypus pygmaeus	CR
Bradypus torquatus	VU
Bradypus tridactylus	LC
Bradypus variegatus	LC
Brassomys albidens	DD
Brucepattersonius griserufescens	DD
Brucepattersonius guarani	DD
Brucepattersonius igniventris	DD
Brucepattersonius iheringi	LC
Brucepattersonius misionensis	DD
Brucepattersonius paradisus	DD
Brucepattersonius soricinus	DD
Bubalus arnee	EN
Bubalus depressicornis	EN
Bubalus mindorensis	CR
Bubalus quarlesi	EN
Budorcas taxicolor	VU
Bullimus bagobus	LC
Bullimus gamay	VU
Bullimus luzonicus	LC
Bunolagus monticularis	CR
Bunomys andrewsi	LC
Bunomys chrysocomus	LC
Bunomys coelestis	EN
Bunomys fratrorum	VU
Bunomys karokophilus	DD
Bunomys penitus	LC
Bunomys prolatus	EN
Bunomys torajae	DD
Burramys parvus	CR
Cabassous centralis	DD
Cabassous chacoensis	NT
Cabassous tatouay	LC
Cabassous unicinctus	LC
Cacajao calvus	VU
Cacajao hosomi	VU
Cacajao melanocephalus	LC
Caenolestes caniventer	NT
Caenolestes condorensis	VU
Caenolestes convelatus	VU
Caenolestes fuliginosus	LC
Caenolestes sangay	VU
Calcochloris obtusirostris	LC
Calcochloris tytonis	DD
Callibella humilis	LC
Callicebus barbarabrownae	CR
Callicebus coimbrai	EN
Callicebus melanochir	VU
Callicebus nigrifrons	NT
Callicebus personatus	VU
Callimico goeldii	VU
Callistomys pictus	EN
Callithrix aurita	VU
Callithrix flaviceps	EN
Callithrix geoffroyi	LC
Callithrix jacchus	LC
Callithrix kuhlii	NT
Callithrix penicillata	LC
Callorhinus ursinus	VU
Callosciurus adamsi	NT
Callosciurus albescens	DD
Callosciurus baluensis	LC
Callosciurus caniceps	LC
Callosciurus erythraeus	LC
Callosciurus finlaysonii	LC
Callosciurus inornatus	LC
Callosciurus melanogaster	VU
Callosciurus nigrovittatus	LC
Callosciurus notatus	LC
Callosciurus orestes	LC
Callosciurus phayrei	LC
Callosciurus prevostii	LC
Callosciurus pygerythrus	LC
Callosciurus quinquestriatus	NT
Callospermophilus lateralis	LC
Callospermophilus madrensis	NT
Callospermophilus saturatus	LC
Calomys boliviae	LC
Calomys callidus	LC
Calomys callosus	LC
Calomys expulsus	LC
Calomys fecundus	LC
Calomys hummelincki	LC
Calomys laucha	LC
Calomys lepidus	LC
Calomys musculinus	LC
Calomys sorellus	LC
Calomys tener	LC
Calomys tocantinsi	LC
Calomys venustus	LC
Calomyscus bailwardi	LC
Calomyscus baluchi	LC
Calomyscus elburzensis	LC
Calomyscus grandis	DD
Calomyscus hotsoni	LC
Calomyscus mystax	LC
Calomyscus tsolovi	DD
Calomyscus urartensis	LC
Caluromys derbianus	LC
Caluromys lanatus	LC
Caluromys philander	LC
Caluromysiops irrupta	LC
Calyptophractus retusus	DD
Camelus ferus	CR
Canis adustus	LC
Canis aureus	LC
Canis latrans	LC
Canis lupaster	LC
Canis lupus	LC
Canis mesomelas	LC
Canis rufus	CR
Canis simensis	EN
Cannomys badius	LC
Cansumys canus	LC
Caperea marginata	LC
Capra aegagrus	VU
Capra caucasica	EN
Capra cylindricornis	NT
Capra falconeri	NT
Capra ibex	LC
Capra nubiana	VU
Capra pyrenaica	LC
Capra sibirica	LC
Capra walie	EN
Capreolus capreolus	LC
Capreolus pygargus	LC
Capricornis crispus	LC
Capricornis milneedwardsii	NT
Capricornis rubidus	NT
Capricornis sumatraensis	VU
Capricornis swinhoei	LC
Capricornis thar	NT
Caprolagus hispidus	EN
Capromys pilorides	LC
Caracal aurata	VU
Caracal caracal	LC
Cardiocranius paradoxus	DD
Cardioderma cor	LC
Carollia benkeithi	LC
Carollia brevicauda	LC
Carollia castanea	LC
Carollia manu	LC
Carollia monohernandezi	DD
Carollia perspicillata	LC
Carollia sowelli	LC
Carollia subrufa	LC
Carpitalpa arendsi	VU
Carpomys melanurus	DD
Carpomys phaeurus	LC
Carterodon sulcidens	DD
Caryomys eva	LC
Caryomys inez	LC
Casinycteris argynnis	LC
Casinycteris campomaanensis	DD
Castor canadensis	LC
Castor fiber	LC
Catagonus wagneri	EN
Catopuma badia	EN
Catopuma temminckii	NT
Cavia aperea	LC
Cavia fulgida	LC
Cavia intermedia	CR
Cavia magna	LC
Cavia patzelti	DD
Cavia tschudii	LC
Cebuella pygmaea	LC
Cebus aequatorialis	CR
Cebus albifrons	LC
Cebus brunneus	LC
Cebus castaneus	LC
Cebus cesarae	DD
Cebus cuscinus	NT
Cebus kaapori	CR
Cebus malitiosus	EN
Cebus versicolor	EN
Centronycteris centralis	LC
Centronycteris maximiliani	LC
Centurio senex	LC
Cephalophus adersi	VU
Cephalophus callipygus	LC
Cephalophus dorsalis	NT
Cephalophus harveyi	LC
Cephalophus jentinki	EN
Cephalophus leucogaster	NT
Cephalophus natalensis	LC
Cephalophus niger	LC
Cephalophus nigrifrons	LC
Cephalophus ogilbyi	LC
Cephalophus rufilatus	LC
Cephalophus silvicultor	NT
Cephalophus spadix	EN
Cephalophus weynsi	LC
Cephalophus zebra	VU
Cephalorhynchus commersonii	LC
Cephalorhynchus eutropia	NT
Cephalorhynchus heavisidii	NT
Cephalorhynchus hectori	EN
Ceratotherium simum	NT
Cercartetus caudatus	LC
Cercartetus concinnus	LC
Cercartetus lepidus	LC
Cercartetus nanus	LC
Cercocebus agilis	LC
Cercocebus atys	NT
Cercocebus chrysogaster	DD
Cercocebus galeritus	EN
Cercocebus lunulatus	EN
Cercocebus sanjei	EN
Cercocebus torquatus	EN
Cercopithecus ascanius	LC
Cercopithecus campbelli	LC
Cercopithecus cephus	LC
Cercopithecus denti	LC
Cercopithecus diana	VU
Cercopithecus dryas	EN
Cercopithecus erythrogaster	VU
Cercopithecus erythrotis	VU
Cercopithecus hamlyni	VU
Cercopithecus lowei	VU
Cercopithecus mitis	LC
Cercopithecus mona	LC
Cercopithecus neglectus	LC
Cercopithecus nictitans	LC
Cercopithecus petaurista	LC
Cercopithecus roloway	CR
Cercopithecus sclateri	EN
Cerdocyon thous	LC
Cerradomys maracajuensis	LC
Cerradomys marinhus	LC
Cerradomys scotti	LC
Cerradomys subflavus	LC
Cervus albirostris	VU
Cervus canadensis	LC
Cervus elaphus	LC
Cervus hanglu	LC
Cervus nippon	LC
Chacodelphys formosa	NT
Chaerephon aloysiisabaudiae	LC
Chaerephon ansorgei	LC
Chaerephon atsinanana	LC
Chaerephon bemmeleni	LC
Chaerephon bivittatus	LC
Chaerephon bregullae	EN
Chaerephon chapini	LC
Chaerephon gallagheri	DD
Chaerephon jobensis	LC
Chaerephon jobimena	LC
Chaerephon johorensis	VU
Chaerephon major	LC
Chaerephon nigeriae	LC
Chaerephon plicatus	LC
Chaerephon pumilus	LC
Chaerephon russatus	DD
Chaerephon solomonis	LC
Chaerephon tomensis	EN
Chaetocauda sichuanensis	DD
Chaetodipus ammophilus	NT
Chaetodipus arenarius	LC
Chaetodipus artus	LC
Chaetodipus baileyi	LC
Chaetodipus californicus	LC
Chaetodipus eremicus	LC
Chaetodipus fallax	LC
Chaetodipus formosus	LC
Chaetodipus goldmani	NT
Chaetodipus hispidus	LC
Chaetodipus intermedius	LC
Chaetodipus lineatus	DD
Chaetodipus nelsoni	LC
Chaetodipus penicillatus	LC
Chaetodipus pernix	LC
Chaetodipus rudinoris	LC
Chaetodipus siccus	LC
Chaetodipus spinatus	LC
Chaetophractus vellerosus	LC
Chaetophractus villosus	LC
Chalinolobus dwyeri	NT
Chalinolobus gouldii	LC
Chalinolobus morio	LC
Chalinolobus neocaledonicus	EN
Chalinolobus nigrogriseus	LC
Chalinolobus picatus	NT
Chalinolobus tuberculatus	VU
Cheirogaleus crossleyi	DD
Cheirogaleus major	DD
Cheirogaleus medius	LC
Cheirogaleus minusculus	DD
Cheirogaleus sibreei	CR
Cheiromeles parvidens	LC
Cheiromeles torquatus	LC
Chelemys macronyx	LC
Chelemys megalonyx	NT
Cheracebus lucifer	LC
Cheracebus lugens	LC
Cheracebus medemi	VU
Cheracebus purinus	LC
Cheracebus regulus	LC
Cheracebus torquatus	LC
Chibchanomys orcesi	DD
Chibchanomys trichotis	DD
Chilomys instans	LC
Chilonatalus macer	DD
Chilonatalus micropus	VU
Chilonatalus tumidifrons	NT
Chimarrogale hantu	NT
Chimarrogale himalayica	LC
Chimarrogale phaeura	EN
Chimarrogale platycephalus	LC
Chimarrogale styani	LC
Chimarrogale sumatrana	DD
Chinchilla chinchilla	EN
Chinchilla lanigera	EN
Chinchillula sahamae	LC
Chionomys gud	LC
Chionomys nivalis	LC
Chionomys roberti	LC
Chiroderma doriae	LC
Chiroderma improvisum	EN
Chiroderma salvini	LC
Chiroderma trinitatum	LC
Chiroderma villosum	LC
Chiroderma vizottoi	DD
Chiromyscus chiropus	LC
Chironax melanocephalus	LC
Chironectes minimus	LC
Chiropodomys calamianensis	DD
Chiropodomys gliroides	LC
Chiropodomys karlkoopmani	VU
Chiropodomys major	LC
Chiropodomys muroides	DD
Chiropodomys pusillus	DD
Chiropotes albinasus	EN
Chiropotes chiropotes	LC
Chiropotes satanas	CR
Chiropotes utahickae	EN
Chiruromys forbesi	LC
Chiruromys lamia	LC
Chiruromys vates	LC
Chlamyphorus truncatus	DD
Chlorocebus aethiops	LC
Chlorocebus cynosuros	LC
Chlorocebus djamdjamensis	VU
Chlorocebus pygerythrus	LC
Chlorocebus sabaeus	LC
Chlorocebus tantalus	LC
Chlorotalpa duthieae	VU
Chlorotalpa sclateri	LC
Chodsigoa caovansunga	DD
Chodsigoa hypsibia	LC
Chodsigoa lamula	LC
Chodsigoa parca	LC
Chodsigoa parva	DD
Chodsigoa salenskii	DD
Chodsigoa smithii	NT
Chodsigoa sodalis	DD
Choeroniscus godmani	LC
Choeroniscus minor	LC
Choeroniscus periosus	VU
Choeronycteris mexicana	NT
Choeropsis liberiensis	EN
Choloepus didactylus	LC
Choloepus hoffmanni	LC
Chrotogale owstoni	EN
Chrotomys gonzalesi	NT
Chrotomys mindorensis	LC
Chrotomys sibuyanensis	DD
Chrotomys silaceus	LC
Chrotomys whiteheadi	LC
Chrotopterus auritus	LC
Chrysochloris asiatica	LC
Chrysochloris stuhlmanni	LC
Chrysochloris visagiei	DD
Chrysocyon brachyurus	NT
Chrysospalax trevelyani	EN
Chrysospalax villosus	VU
Cistugo lesueuri	LC
Cistugo seabrae	LC
Civettictis civetta	LC
Cloeotis percivali	LC
Clyomys laticeps	LC
Coccymys kirrhos	DD
Coccymys ruemmleri	LC
Coccymys shawmayeri	LC
Coelops frithii	LC
Coelops robinsoni	VU
Coendou baturitensis	DD
Coendou bicolor	LC
Coendou ichillus	DD
Coendou insidiosus	LC
Coendou melanurus	LC
Coendou mexicanus	LC
Coendou nycthemera	DD
Coendou prehensilis	LC
Coendou pruinosus	LC
Coendou quichua	DD
Coendou roosmalenorum	DD
Coendou rufescens	LC
Coendou speratus	EN
Coendou spinosus	LC
Coendou vestitus	DD
Coleura afra	LC
Coleura kibomalandy	DD
Coleura seychellensis	CR
Colobus angolensis	LC
Colobus guereza	LC
Colobus polykomos	VU
Colobus satanas	VU
Colobus vellerosus	VU
Colomys goslingi	LC
Condylura cristata	LC
Conepatus chinga	LC
Conepatus humboldtii	LC
Conepatus leuconotus	LC
Conepatus semistriatus	LC
Congosorex phillipsorum	CR
Congosorex polli	DD
Congosorex verheyeni	LC
Conilurus penicillatus	VU
Connochaetes gnou	LC
Connochaetes taurinus	LC
Cormura brevirostris	LC
Corynorhinus mexicanus	NT
Corynorhinus rafinesquii	LC
Corynorhinus townsendii	LC
Craseonycteris thonglongyai	VU
Crateromys australis	DD
Crateromys heaneyi	EN
Crateromys paulus	DD
Crateromys schadenbergi	EN
Cratogeomys castanops	LC
Cratogeomys fulvescens	LC
Cratogeomys fumosus	LC
Cratogeomys goldmani	LC
Cratogeomys merriami	LC
Cratogeomys perotensis	LC
Cratogeomys planiceps	LC
Cremnomys cutchicus	LC
Cremnomys elvira	CR
Cricetomys ansorgei	LC
Cricetomys emini	LC
Cricetomys gambianus	LC
Cricetulus alticola	LC
Cricetulus barabensis	LC
Cricetulus kamensis	LC
Cricetulus lama	LC
Cricetulus longicaudatus	LC
Cricetulus migratorius	LC
Cricetulus sokolovi	LC
Cricetulus tibetanus	LC
Cricetus cricetus	LC
Crocidura absconditus	DD
Crocidura afeworkbekelei	DD
Crocidura aleksandrisi	LC
Crocidura allex	VU
Crocidura andamanensis	CR
Crocidura annamitensis	DD
Crocidura ansellorum	EN
Crocidura arabica	LC
Crocidura arispa	LC
Crocidura armenica	DD
Crocidura attenuata	LC
Crocidura attila	LC
Crocidura baileyi	LC
Crocidura baluensis	LC
Crocidura batakorum	DD
Crocidura batesi	LC
Crocidura beatus	LC
Crocidura beccarii	LC
Crocidura bottegi	DD
Crocidura bottegoides	EN
Crocidura brunnea	LC
Crocidura buettikoferi	NT
Crocidura caliginea	LC
Crocidura canariensis	EN
Crocidura caspica	DD
Crocidura cinderella	LC
Crocidura congobelgica	LC
Crocidura cranbrooki	DD
Crocidura crenata	LC
Crocidura crossei	LC
Crocidura cyanea	LC
Crocidura denti	LC
Crocidura desperata	EN
Crocidura dhofarensis	DD
Crocidura dolichura	LC
Crocidura douceti	LC
Crocidura dsinezumi	LC
Crocidura eburnea	LC
Crocidura eisentrauti	VU
Crocidura elgonius	LC
Crocidura elongata	LC
Crocidura erica	DD
Crocidura fingui	DD
Crocidura fischeri	DD
Crocidura flavescens	LC
Crocidura floweri	DD
Crocidura foetida	LC
Crocidura foxi	LC
Crocidura fuliginosa	LC
Crocidura fulvastra	LC
Crocidura fumosa	LC
Crocidura fuscomurina	LC
Crocidura gathornei	DD
Crocidura glassi	NT
Crocidura gmelini	LC
Crocidura goliath	LC
Crocidura gracilipes	DD
Crocidura grandiceps	NT
Crocidura grandis	DD
Crocidura grassei	LC
Crocidura grayi	LC
Crocidura greenwoodi	LC
Crocidura guy	DD
Crocidura harenna	CR
Crocidura hikmiya	EN
Crocidura hildegardeae	LC
Crocidura hilliana	DD
Crocidura hirta	LC
Crocidura hispida	VU
Crocidura horsfieldii	DD
Crocidura hutanis	LC
Crocidura indochinensis	LC
Crocidura jacksoni	LC
Crocidura jenkinsi	CR
Crocidura jouvenetae	LC
Crocidura katinka	DD
Crocidura kivuana	NT
Crocidura lamottei	LC
Crocidura lanosa	VU
Crocidura lasiura	LC
Crocidura latona	LC
Crocidura lea	LC
Crocidura lepidura	LC
Crocidura leucodon	LC
Crocidura levicula	LC
Crocidura littoralis	LC
Crocidura longipes	DD
Crocidura lucina	VU
Crocidura ludia	LC
Crocidura luna	LC
Crocidura lusitania	LC
Crocidura lwiroensis	DD
Crocidura macarthuri	LC
Crocidura macmillani	NT
Crocidura macowi	DD
Crocidura malayana	LC
Crocidura manengubae	VU
Crocidura maquassiensis	LC
Crocidura mariquensis	LC
Crocidura maurisca	LC
Crocidura maxi	LC
Crocidura mdumai	EN
Crocidura mindorus	DD
Crocidura miya	EN
Crocidura monax	DD
Crocidura monticola	LC
Crocidura montis	LC
Crocidura munissii	LC
Crocidura muricauda	LC
Crocidura musseri	DD
Crocidura mutesae	DD
Crocidura nana	DD
Crocidura nanilla	LC
Crocidura negligens	LC
Crocidura negrina	EN
Crocidura newmarki	NT
Crocidura nicobarica	CR
Crocidura nigeriae	LC
Crocidura nigricans	LC
Crocidura nigripes	LC
Crocidura nigrofusca	LC
Crocidura nimbae	NT
Crocidura ninoyi	DD
Crocidura niobe	LC
Crocidura obscurior	LC
Crocidura olivieri	LC
Crocidura orientalis	LC
Crocidura orii	EN
Crocidura pachyura	LC
Crocidura palawanensis	LC
Crocidura panayensis	DD
Crocidura paradoxura	LC
Crocidura parvipes	LC
Crocidura pasha	LC
Crocidura pergrisea	DD
Crocidura phaeura	EN
Crocidura phanluongi	LC
Crocidura phuquocensis	DD
Crocidura picea	EN
Crocidura pitmani	DD
Crocidura planiceps	DD
Crocidura poensis	LC
Crocidura polia	DD
Crocidura pullata	DD
Crocidura raineyi	DD
Crocidura ramona	LC
Crocidura rapax	DD
Crocidura religiosa	DD
Crocidura rhoditis	LC
Crocidura roosevelti	LC
Crocidura russula	LC
Crocidura sapaensis	DD
Crocidura selina	DD
Crocidura serezkyensis	LC
Crocidura shantungensis	LC
Crocidura sibirica	LC
Crocidura sicula	LC
Crocidura silacea	LC
Crocidura smithii	LC
Crocidura sokolovi	DD
Crocidura somalica	LC
Crocidura stenocephala	EN
Crocidura suaveolens	LC
Crocidura susiana	DD
Crocidura tanakae	LC
Crocidura tansaniana	NT
Crocidura tarella	EN
Crocidura tarfayensis	DD
Crocidura telfordi	VU
Crocidura tenuis	DD
Crocidura thalia	LC
Crocidura theresae	LC
Crocidura thomensis	EN
Crocidura trichura	CR
Crocidura turba	LC
Crocidura ultima	DD
Crocidura umbra	NT
Crocidura usambarae	VU
Crocidura viaria	LC
Crocidura virgata	LC
Crocidura voi	LC
Crocidura vorax	LC
Crocidura vosmaeri	DD
Crocidura watasei	LC
Crocidura whitakeri	LC
Crocidura wimmeri	CR
Crocidura wuchihensis	DD
Crocidura xantippe	LC
Crocidura yaldeni	DD
Crocidura yankariensis	LC
Crocidura zaitsevi	DD
Crocidura zaphiri	DD
Crocidura zarudnyi	LC
Crocidura zimmeri	DD
Crocidura zimmermanni	EN
Crocuta crocuta	LC
Crossarchus alexandri	LC
Crossarchus ansorgei	LC
Crossarchus obscurus	LC
Crossarchus platycephalus	LC
Crossomys moncktoni	LC
Crunomys celebensis	DD
Crunomys fallax	DD
Crunomys melanius	LC
Crunomys suncoides	DD
Cryptochloris wintoni	CR
Cryptochloris zyli	EN
Cryptomys hottentotus	LC
Cryptomys mahali	DD
Cryptomys natalensis	LC
Cryptomys pretoriae	LC
Cryptonanus agricolai	DD
Cryptonanus chacoensis	LC
Cryptonanus guahybae	DD
Cryptonanus unduaviensis	DD
Cryptoprocta ferox	VU
Cryptotis alticola	DD
Cryptotis aroensis	EN
Cryptotis brachyonyx	DD
Cryptotis cavatorculus	DD
Cryptotis celaque	DD
Cryptotis colombiana	LC
Cryptotis endersi	EN
Cryptotis equatoris	LC
Cryptotis goldmani	LC
Cryptotis goodwini	LC
Cryptotis gracilis	VU
Cryptotis griseoventris	EN
Cryptotis hondurensis	DD
Cryptotis lacertosus	DD
Cryptotis magna	VU
Cryptotis mam	DD
Cryptotis mayensis	LC
Cryptotis mccarthyi	DD
Cryptotis medellinia	LC
Cryptotis meridensis	VU
Cryptotis merriami	LC
Cryptotis merus	EN
Cryptotis mexicana	LC
Cryptotis montivaga	LC
Cryptotis nelsoni	CR
Cryptotis niausia	DD
Cryptotis nigrescens	LC
Cryptotis obscura	LC
Cryptotis orophila	DD
Cryptotis parva	LC
Cryptotis peregrina	DD
Cryptotis perijensis	DD
Cryptotis peruviensis	DD
Cryptotis phillipsii	VU
Cryptotis squamipes	LC
Cryptotis tamensis	LC
Cryptotis thomasi	LC
Cryptotis tropicalis	DD
Cryptotis venezuelensis	DD
Ctenodactylus gundi	LC
Ctenodactylus vali	DD
Ctenomys argentinus	NT
Ctenomys australis	EN
Ctenomys azarae	VU
Ctenomys bergi	VU
Ctenomys boliviensis	LC
Ctenomys bonettoi	EN
Ctenomys brasiliensis	DD
Ctenomys colburni	DD
Ctenomys coludo	DD
Ctenomys conoveri	LC
Ctenomys coyhaiquensis	DD
Ctenomys dorbignyi	NT
Ctenomys dorsalis	DD
Ctenomys emilianus	NT
Ctenomys famosus	DD
Ctenomys flamarioni	EN
Ctenomys fochi	DD
Ctenomys fodax	DD
Ctenomys frater	LC
Ctenomys fulvus	DD
Ctenomys goodfellowi	LC
Ctenomys haigi	LC
Ctenomys johannis	DD
Ctenomys juris	DD
Ctenomys knighti	DD
Ctenomys lami	VU
Ctenomys latro	VU
Ctenomys leucodon	LC
Ctenomys lewisi	LC
Ctenomys magellanicus	LC
Ctenomys maulinus	LC
Ctenomys mendocinus	LC
Ctenomys minutus	DD
Ctenomys occultus	EN
Ctenomys opimus	LC
Ctenomys osvaldoreigi	CR
Ctenomys pearsoni	NT
Ctenomys perrensi	LC
Ctenomys peruanus	LC
Ctenomys pilarensis	EN
Ctenomys pontifex	DD
Ctenomys porteousi	NT
Ctenomys pundti	VU
Ctenomys rionegrensis	EN
Ctenomys roigi	CR
Ctenomys saltarius	DD
Ctenomys scagliai	DD
Ctenomys sericeus	DD
Ctenomys sociabilis	CR
Ctenomys steinbachi	LC
Ctenomys talarum	LC
Ctenomys torquatus	LC
Ctenomys tuconax	DD
Ctenomys tucumanus	DD
Ctenomys tulduco	DD
Ctenomys validus	DD
Ctenomys viperinus	DD
Ctenomys yolandae	DD
Cuniculus paca	LC
Cuniculus taczanowskii	NT
Cuon alpinus	EN
Cuscomys ashaninka	DD
Cuscomys oblativa	DD
Cyclopes didactylus	LC
Cyclopes didactylus	LC
Cynictis penicillata	LC
Cynocephalus volans	LC
Cynogale bennettii	EN
Cynomops abrasus	DD
Cynomops greenhalli	LC
Cynomops mexicanus	LC
Cynomops milleri	LC
Cynomops paranus	DD
Cynomops planirostris	LC
Cynomys gunnisoni	LC
Cynomys leucurus	LC
Cynomys ludovicianus	LC
Cynomys mexicanus	EN
Cynomys parvidens	EN
Cynopterus brachyotis	LC
Cynopterus horsfieldii	LC
Cynopterus luzoniensis	LC
Cynopterus minutus	LC
Cynopterus nusatenggara	LC
Cynopterus sphinx	LC
Cynopterus titthaecheilus	LC
Cystophora cristata	VU
Cyttarops alecto	LC
Dacnomys millardi	DD
Dactylomys boliviensis	LC
Dactylomys dactylinus	LC
Dactylomys peruanus	DD
Dactylonax palpator	LC
Dactylopsila megalura	LC
Dactylopsila tatei	EN
Dactylopsila trivirgata	LC
Dama dama	LC
Dama mesopotamica	EN
Damaliscus lunatus	LC
Damaliscus pygargus	LC
Dasycercus blythi	LC
Dasycercus cristicauda	NT
Dasykaluta rosamondae	LC
Dasymys foxi	DD
Dasymys incomtus	LC
Dasymys montanus	EN
Dasymys nudipes	DD
Dasymys rufulus	LC
Dasyprocta azarae	DD
Dasyprocta coibae	NT
Dasyprocta croconota	DD
Dasyprocta fuliginosa	LC
Dasyprocta guamara	NT
Dasyprocta iacki	DD
Dasyprocta kalinowskii	DD
Dasyprocta leporina	LC
Dasyprocta mexicana	CR
Dasyprocta prymnolopha	LC
Dasyprocta punctata	LC
Dasyprocta ruatanica	EN
Dasyprocta variegata	DD
Dasypus hybridus	NT
Dasypus kappleri	LC
Dasypus novemcinctus	LC
Dasypus pilosus	DD
Dasypus sabanicola	NT
Dasypus septemcinctus	LC
Dasypus yepesi	DD
Dasyuroides byrnei	VU
Dasyurus albopunctatus	NT
Dasyurus geoffroii	NT
Dasyurus hallucatus	EN
Dasyurus maculatus	NT
Dasyurus spartacus	NT
Dasyurus viverrinus	EN
Daubentonia madagascariensis	EN
Delanymys brooksi	VU
Delomys collinus	LC
Delomys dorsalis	LC
Delomys sublineatus	LC
Delphinapterus leucas	LC
Delphinapterus leucas	LC
Delphinus capensis	DD
Delphinus delphis	LC
Delphinus delphis	LC
Deltamys kempi	LC
Dendrogale melanura	DD
Dendrogale murina	LC
Dendrohyrax arboreus	LC
Dendrohyrax dorsalis	LC
Dendrohyrax validus	NT
Dendrolagus bennettianus	NT
Dendrolagus dorianus	VU
Dendrolagus goodfellowi	EN
Dendrolagus inustus	VU
Dendrolagus lumholtzi	NT
Dendrolagus matschiei	EN
Dendrolagus mayri	CR
Dendrolagus mbaiso	EN
Dendrolagus notatus	EN
Dendrolagus pulcherrimus	CR
Dendrolagus scottae	CR
Dendrolagus spadix	VU
Dendrolagus stellarum	VU
Dendrolagus ursinus	VU
Dendromus insignis	LC
Dendromus kahuziensis	CR
Dendromus kivu	LC
Dendromus lachaisei	DD
Dendromus lovati	LC
Dendromus melanotis	LC
Dendromus mesomelas	LC
Dendromus messorius	LC
Dendromus mystacalis	LC
Dendromus nyikae	LC
Dendromus oreas	LC
Dendromus ruppi	DD
Dendromus vernayi	DD
Dendroprionomys rousseloti	DD
Deomys ferrugineus	LC
Dephomys defua	LC
Dermanura anderseni	LC
Dermanura azteca	LC
Dermanura bogotensis	LC
Dermanura cinerea	LC
Dermanura glauca	LC
Dermanura gnoma	LC
Dermanura phaeotis	LC
Dermanura rava	LC
Dermanura rosenbergi	DD
Dermanura tolteca	LC
Dermanura watsoni	LC
Desmana moschata	EN
Desmodilliscus braueri	LC
Desmodillus auricularis	LC
Desmodus rotundus	LC
Desmomys harringtoni	LC
Desmomys yaldeni	VU
Diaemus youngi	LC
Dicerorhinus sumatrensis	CR
Diceros bicornis	CR
Diclidurus albus	LC
Diclidurus ingens	DD
Diclidurus isabella	LC
Diclidurus scutatus	LC
Dicrostonyx groenlandicus	LC
Dicrostonyx hudsonius	LC
Dicrostonyx nelsoni	LC
Dicrostonyx nunatakensis	LC
Dicrostonyx richardsoni	LC
Dicrostonyx torquatus	LC
Dicrostonyx unalascensis	DD
Dicrostonyx vinogradovi	DD
Didelphis albiventris	LC
Didelphis aurita	LC
Didelphis imperfecta	LC
Didelphis marsupialis	LC
Didelphis pernigra	LC
Didelphis virginiana	LC
Dinaromys bogdanovi	VU
Dinomys branickii	LC
Diomys crumpi	DD
Diphylla ecaudata	LC
Diplogale hosei	VU
Diplomesodon pulchellum	LC
Diplomys caniceps	DD
Diplomys labilis	LC
Diplothrix legata	EN
Dipodomys agilis	LC
Dipodomys californicus	LC
Dipodomys compactus	LC
Dipodomys deserti	LC
Dipodomys elator	VU
Dipodomys gravipes	CR
Dipodomys heermanni	LC
Dipodomys ingens	EN
Dipodomys merriami	LC
Dipodomys microps	LC
Dipodomys nelsoni	LC
Dipodomys nitratoides	VU
Dipodomys ordii	LC
Dipodomys ornatus	LC
Dipodomys panamintinus	LC
Dipodomys phillipsii	LC
Dipodomys simulans	LC
Dipodomys spectabilis	NT
Dipodomys stephensi	VU
Dipodomys venustus	LC
Dipus sagitta	LC
Distoechurus pennatus	LC
Dobsonia anderseni	LC
Dobsonia beauforti	LC
Dobsonia chapmani	CR
Dobsonia crenulata	LC
Dobsonia emersa	VU
Dobsonia exoleta	LC
Dobsonia inermis	LC
Dobsonia minor	LC
Dobsonia moluccensis	LC
Dobsonia pannietensis	NT
Dobsonia peronii	LC
Dobsonia praedatrix	LC
Dobsonia viridis	LC
Dolichotis patagonum	NT
Dolichotis salinicola	LC
Dologale dybowskii	DD
Dorcatragus megalotis	VU
Dorcopsis atrata	CR
Dorcopsis hageni	LC
Dorcopsis luctuosa	VU
Dorcopsis muelleri	LC
Dorcopsulus macleayi	LC
Dorcopsulus vanheurni	NT
Dremomys everetti	LC
Dremomys gularis	DD
Dremomys lokriah	LC
Dremomys pernyi	LC
Dremomys pyrrhomerus	LC
Dremomys rufigenis	LC
Dromiciops gliroides	NT
Dryadonycteris capixaba	DD
Drymoreomys albimaculatus	NT
Dryomys laniger	DD
Dryomys niethammeri	VU
Dryomys nitedula	LC
Dugong dugon	VU
Dyacopterus brooksi	VU
Dyacopterus spadiceus	NT
Dymecodon pilirostris	LC
Echimys chrysurus	LC
Echimys saturnus	DD
Echimys vieirai	DD
Echinops telfairi	LC
Echinosorex gymnura	LC
Echiothrix centrosa	VU
Echiothrix leucura	EN
Echymipera clara	LC
Echymipera davidi	EN
Echymipera echinista	DD
Echymipera kalubu	LC
Echymipera rufescens	LC
Ectophylla alba	NT
Eidolon dupreanum	VU
Eidolon helvum	NT
Eira barbara	LC
Elaphodus cephalophus	NT
Elephantulus brachyrhynchus	LC
Elephantulus edwardii	LC
Elephantulus fuscipes	DD
Elephantulus fuscus	DD
Elephantulus intufi	LC
Elephantulus myurus	LC
Elephantulus pilicaudus	DD
Elephantulus revoilii	DD
Elephantulus rozeti	LC
Elephantulus rufescens	LC
Elephantulus rupestris	LC
Elephas maximus	EN
Eligmodontia moreni	LC
Eligmodontia morgani	LC
Eligmodontia puerulus	LC
Eligmodontia typus	LC
Eliomys melanurus	LC
Eliomys munbyanus	LC
Eliomys quercinus	NT
Eliurus antsingy	DD
Eliurus carletoni	LC
Eliurus danieli	LC
Eliurus ellermani	DD
Eliurus grandidieri	LC
Eliurus majori	LC
Eliurus minor	LC
Eliurus myoxinus	LC
Eliurus penicillatus	EN
Eliurus petteri	EN
Eliurus tanala	LC
Eliurus webbi	LC
Ellobius alaicus	DD
Ellobius fuscocapillus	LC
Ellobius lutescens	LC
Ellobius talpinus	LC
Ellobius tancrei	LC
Emballonura alecto	LC
Emballonura beccarii	LC
Emballonura dianae	LC
Emballonura furax	LC
Emballonura monticola	LC
Emballonura raffrayana	LC
Emballonura semicaudata	EN
Emballonura serii	LC
Enchisthenes hartii	LC
Enhydra lutris	EN
Eoglaucomys fimbriatus	LC
Eolagurus luteus	LC
Eolagurus przewalskii	LC
Eonycteris major	DD
Eonycteris robusta	NT
Eonycteris spelaea	LC
Eospalax fontanierii	LC
Eospalax rothschildi	LC
Eospalax smithii	LC
Eothenomys cachinus	LC
Eothenomys chinensis	LC
Eothenomys custos	LC
Eothenomys melanogaster	LC
Eothenomys miletus	LC
Eothenomys olitor	LC
Eothenomys proditor	DD
Eothenomys wardi	NT
Eozapus setchuanus	LC
Episoriculus caudatus	LC
Episoriculus fumidus	LC
Episoriculus leucops	LC
Episoriculus macrurus	LC
Epixerus ebii	LC
Epomophorus angolensis	NT
Epomophorus anselli	DD
Epomophorus crypturus	LC
Epomophorus gambianus	LC
Epomophorus grandis	DD
Epomophorus labiatus	LC
Epomophorus minimus	LC
Epomophorus minor	LC
Epomophorus wahlbergi	LC
Epomops buettikoferi	LC
Epomops dobsonii	LC
Epomops franqueti	LC
Eptesicus andinus	LC
Eptesicus bobrinskoi	LC
Eptesicus bottae	LC
Eptesicus brasiliensis	LC
Eptesicus chiriquinus	LC
Eptesicus diminutus	LC
Eptesicus dimissus	DD
Eptesicus floweri	LC
Eptesicus furinalis	LC
Eptesicus fuscus	LC
Eptesicus gobiensis	LC
Eptesicus guadeloupensis	EN
Eptesicus hottentotus	LC
Eptesicus innoxius	NT
Eptesicus isabellinus	LC
Eptesicus japonensis	EN
Eptesicus kobayashii	DD
Eptesicus nasutus	LC
Eptesicus nilssonii	LC
Eptesicus pachyotis	LC
Eptesicus platyops	DD
Eptesicus serotinus	LC
Eptesicus taddeii	DD
Eptesicus tatei	DD
Equus africanus	CR
Equus ferus	EN
Equus grevyi	EN
Equus hemionus	NT
Equus kiang	LC
Equus quagga	NT
Equus zebra	VU
Eremitalpa granti	LC
Eremodipus lichtensteini	LC
Eremoryzomys polius	DD
Erethizon dorsatum	LC
Erignathus barbatus	LC
Erinaceus amurensis	LC
Erinaceus concolor	LC
Erinaceus europaeus	LC
Erinaceus roumanicus	LC
Eropeplus canus	VU
Erophylla bombifrons	LC
Erophylla sezekorni	LC
Erythrocebus patas	LC
Eschrichtius robustus	LC
Eschrichtius robustus	LC
Eubalaena australis	LC
Eubalaena australis	LC
Eubalaena glacialis	EN
Eubalaena japonica	EN
Eubalaena japonica	EN
Euchoreutes naso	LC
Euderma maculatum	LC
Eudiscoderma thongareeae	CR
Eudiscopus denticulus	LC
Eudorcas albonotata	LC
Eudorcas rufifrons	VU
Eudorcas rufina	DD
Eudorcas thomsonii	LC
Eudorcas tilonura	EN
Eulemur albifrons	EN
Eulemur cinereiceps	CR
Eulemur collaris	EN
Eulemur coronatus	EN
Eulemur flavifrons	CR
Eulemur fulvus	NT
Eulemur macaco	VU
Eulemur mongoz	CR
Eulemur rubriventer	VU
Eulemur rufifrons	NT
Eulemur rufus	VU
Eulemur sanfordi	EN
Eumetopias jubatus	NT
Eumops auripendulus	LC
Eumops bonariensis	LC
Eumops dabbenei	LC
Eumops delticus	DD
Eumops ferox	LC
Eumops floridanus	VU
Eumops glaucinus	LC
Eumops hansae	LC
Eumops maurus	DD
Eumops nanus	LC
Eumops patagonicus	LC
Eumops perotis	LC
Eumops trumbulli	LC
Eumops underwoodi	LC
Eumops wilsoni	DD
Euneomys chinchilloides	DD
Euneomys fossor	DD
Euneomys mordax	LC
Euneomys petersoni	LC
Euoticus elegantulus	LC
Euoticus pallidus	LC
Eupetaurus cinereus	EN
Euphractus sexcinctus	LC
Eupleres goudotii	VU
Eupleres major	EN
Euroscaptor grandis	LC
Euroscaptor klossi	LC
Euroscaptor longirostris	LC
Euroscaptor micrura	LC
Euroscaptor mizura	LC
Euroscaptor parvidens	DD
Euroscaptor subanura	DD
Euryoryzomys emmonsae	DD
Euryoryzomys lamia	VU
Euryoryzomys legatus	LC
Euryoryzomys macconnelli	LC
Euryoryzomys nitidus	LC
Euryoryzomys russatus	LC
Euryzygomatomys spinosus	LC
Eutamias sibiricus	LC
Exilisciurus concinnus	LC
Exilisciurus exilis	DD
Exilisciurus whiteheadi	LC
Falsistrellus affinis	LC
Falsistrellus mackenziei	NT
Falsistrellus mordax	DD
Falsistrellus petersi	DD
Falsistrellus tasmaniensis	LC
Felis bieti	VU
Felis chaus	LC
Felis margarita	LC
Felis nigripes	VU
Felis silvestris	LC
Felovia vae	LC
Feresa attenuata	LC
Feroculus feroculus	EN
Fossa fossana	VU
Fukomys anselli	NT
Fukomys bocagei	LC
Fukomys damarensis	LC
Fukomys darlingi	LC
Fukomys foxi	DD
Fukomys ilariae	DD
Fukomys kafuensis	VU
Fukomys mechowii	LC
Fukomys ochraceocinereus	LC
Fukomys vandewoestijneae	DD
Fukomys zechi	LC
Funambulus layardi	VU
Funambulus palmarum	LC
Funambulus pennantii	LC
Funambulus sublineatus	VU
Funambulus tristriatus	LC
Funisciurus anerythrus	LC
Funisciurus bayonii	DD
Funisciurus carruthersi	LC
Funisciurus congicus	LC
Funisciurus duchaillui	DD
Funisciurus isabella	LC
Funisciurus lemniscatus	LC
Funisciurus leucogenys	LC
Funisciurus pyrropus	LC
Funisciurus substriatus	DD
Furipterus horrens	LC
Galago gallarum	LC
Galago matschiei	LC
Galago moholi	LC
Galago senegalensis	LC
Galagoides cocos	LC
Galagoides demidoff	LC
Galagoides granti	LC
Galagoides orinus	NT
Galagoides rondoensis	CR
Galagoides thomasi	LC
Galagoides zanzibaricus	LC
Galea comes	DD
Galea flavidens	LC
Galea leucoblephara	LC
Galea musteloides	DD
Galea spixii	LC
Galemys pyrenaicus	VU
Galenomys garleppi	DD
Galeopterus variegatus	LC
Galictis cuja	LC
Galictis vittata	LC
Galidia elegans	LC
Galidictis fasciata	VU
Galidictis grandidieri	EN
Gardnerycteris crenulatum	LC
Gardnerycteris koepckeae	DD
Gazella arabica	VU
Gazella bennettii	LC
Gazella cuvieri	VU
Gazella dorcas	VU
Gazella gazella	EN
Gazella leptoceros	EN
Gazella marica	VU
Gazella spekei	EN
Gazella subgutturosa	VU
Genetta abyssinica	DD
Genetta angolensis	LC
Genetta bourloni	VU
Genetta cristata	VU
Genetta genetta	LC
Genetta johnstoni	NT
Genetta maculata	LC
Genetta pardina	LC
Genetta piscivora	NT
Genetta poensis	DD
Genetta servalina	LC
Genetta thierryi	LC
Genetta tigrina	LC
Genetta victoriae	LC
Geocapromys brownii	EN
Geocapromys ingrahami	VU
Geogale aurita	LC
Geomys arenarius	NT
Geomys attwateri	LC
Geomys breviceps	LC
Geomys bursarius	LC
Geomys knoxjonesi	LC
Geomys personatus	LC
Geomys pinetis	LC
Geomys texensis	LC
Geomys tropicalis	EN
Georychus capensis	LC
Geoxus annectens	VU
Geoxus valdivianus	LC
Gerbilliscus afra	LC
Gerbilliscus boehmi	LC
Gerbilliscus brantsii	LC
Gerbilliscus gambiana	LC
Gerbilliscus guineae	LC
Gerbilliscus inclusus	LC
Gerbilliscus kempi	LC
Gerbilliscus leucogaster	LC
Gerbilliscus nigricaudus	LC
Gerbilliscus phillipsi	LC
Gerbilliscus robustus	LC
Gerbilliscus validus	LC
Gerbillurus paeba	LC
Gerbillurus setzeri	LC
Gerbillurus tytonis	LC
Gerbillurus vallinus	LC
Gerbillus acticola	DD
Gerbillus agag	DD
Gerbillus amoenus	LC
Gerbillus andersoni	LC
Gerbillus aquilus	LC
Gerbillus bottai	DD
Gerbillus brockmani	DD
Gerbillus burtoni	DD
Gerbillus campestris	LC
Gerbillus cheesmani	LC
Gerbillus cosensis	DD
Gerbillus dasyurus	LC
Gerbillus dunni	LC
Gerbillus famulus	LC
Gerbillus floweri	LC
Gerbillus gerbillus	LC
Gerbillus gleadowi	LC
Gerbillus grobbeni	DD
Gerbillus harwoodi	LC
Gerbillus henleyi	LC
Gerbillus hesperinus	EN
Gerbillus hoogstraali	VU
Gerbillus jamesi	DD
Gerbillus juliani	LC
Gerbillus latastei	DD
Gerbillus lowei	DD
Gerbillus mackilligini	LC
Gerbillus maghrebi	LC
Gerbillus mesopotamiae	LC
Gerbillus muriculus	DD
Gerbillus nancillus	DD
Gerbillus nanus	LC
Gerbillus nigeriae	LC
Gerbillus occiduus	DD
Gerbillus percivali	DD
Gerbillus perpallidus	LC
Gerbillus poecilops	LC
Gerbillus principulus	DD
Gerbillus pulvinatus	LC
Gerbillus pusillus	LC
Gerbillus pyramidum	LC
Gerbillus rosalinda	LC
Gerbillus rupicola	LC
Gerbillus simoni	LC
Gerbillus somalicus	DD
Gerbillus stigmonyx	DD
Gerbillus tarabuli	LC
Gerbillus watersi	LC
Giraffa camelopardalis	VU
Glaucomys sabrinus	LC
Glaucomys volans	LC
Glauconycteris alboguttata	LC
Glauconycteris argentata	LC
Glauconycteris beatrix	LC
Glauconycteris curryae	DD
Glauconycteris egeria	DD
Glauconycteris gleni	DD
Glauconycteris humeralis	DD
Glauconycteris kenyacola	DD
Glauconycteris machadoi	DD
Glauconycteris poensis	LC
Glauconycteris superba	LC
Glauconycteris variegata	LC
Glironia venusta	LC
Glirulus japonicus	LC
Glis glis	LC
Glischropus javanus	DD
Glischropus tylopus	LC
Globicephala macrorhynchus	LC
Globicephala melas	LC
Globicephala melas	LC
Glossophaga commissarisi	LC
Glossophaga leachii	LC
Glossophaga longirostris	LC
Glossophaga morenoi	LC
Glossophaga soricina	LC
Glyphonycteris behnii	DD
Glyphonycteris daviesi	LC
Glyphonycteris sylvestris	LC
Glyphotes simus	DD
Golunda ellioti	LC
Gorilla beringei	CR
Gorilla gorilla	CR
Gracilimus radix	DD
Gracilinanus aceramarcae	LC
Gracilinanus agilis	LC
Gracilinanus dryas	LC
Gracilinanus emiliae	DD
Gracilinanus marica	LC
Gracilinanus microtarsus	LC
Grammomys aridulus	DD
Grammomys brevirostris	DD
Grammomys buntingi	DD
Grammomys caniceps	DD
Grammomys cometes	LC
Grammomys dolichurus	LC
Grammomys dryas	LC
Grammomys gigas	EN
Grammomys ibeanus	LC
Grammomys kuru	LC
Grammomys macmillani	LC
Grammomys minnae	VU
Grammomys selousi	LC
Grampus griseus	LC
Grampus griseus	LC
Graomys chacoensis	DD
Graomys domorum	LC
Graomys edithae	DD
Graomys griseoflavus	LC
Graphiurus angolensis	DD
Graphiurus christyi	LC
Graphiurus crassicaudatus	DD
Graphiurus johnstoni	DD
Graphiurus kelleni	LC
Graphiurus lorraineus	LC
Graphiurus microtis	LC
Graphiurus monardi	DD
Graphiurus murinus	LC
Graphiurus nagtglasii	LC
Graphiurus ocularis	LC
Graphiurus platyops	LC
Graphiurus rupicola	LC
Graphiurus surdus	DD
Graphiurus walterverheyeni	DD
Gulo gulo	LC
Gyldenstolpia fronto	CR
Gymnobelideus leadbeateri	CR
Gymnuromys roberti	LC
Habromys chinanteco	CR
Habromys delicatulus	EN
Habromys ixtlani	CR
Habromys lepturus	CR
Habromys lophurus	NT
Habromys schmidlyi	CR
Habromys simulatus	CR
Hadromys humei	EN
Hadromys yunnanensis	DD
Haeromys margarettae	DD
Haeromys minahassae	VU
Haeromys pusillus	VU
Halichoerus grypus	LC
Halichoerus grypus	LC
Halmaheramys bokimekot	DD
Handleyomys alfaroi	LC
Handleyomys chapmani	VU
Handleyomys fuscatus	LC
Handleyomys intectus	LC
Handleyomys melanotis	LC
Handleyomys rhabdops	VU
Handleyomys rostratus	LC
Handleyomys saturatior	NT
Hapalemur alaotrensis	CR
Hapalemur aureus	CR
Hapalemur griseus	VU
Hapalemur meridionalis	VU
Hapalemur occidentalis	VU
Hapalomys delacouri	VU
Hapalomys longicaudatus	EN
Haplonycteris fischeri	LC
Harpiocephalus harpia	LC
Harpiola grisea	DD
Harpiola isodon	DD
Harpyionycteris celebensis	VU
Harpyionycteris whiteheadi	LC
Heimyscus fumosus	LC
Helarctos malayanus	VU
Heliophobius argenteocinereus	LC
Heliosciurus gambianus	LC
Heliosciurus mutabilis	LC
Heliosciurus punctatus	DD
Heliosciurus rufobrachium	LC
Heliosciurus ruwenzorii	LC
Heliosciurus undulatus	DD
Helogale hirtula	LC
Helogale parvula	LC
Hemibelideus lemuroides	NT
Hemicentetes nigriceps	LC
Hemicentetes semispinosus	LC
Hemiechinus auritus	LC
Hemiechinus collaris	LC
Hemigalus derbyanus	NT
Hemitragus jemlahicus	NT
Herpailurus yagouaroundi	LC
Herpestes auropunctatus	LC
Herpestes brachyurus	NT
Herpestes edwardsii	LC
Herpestes flavescens	LC
Herpestes fuscus	LC
Herpestes ichneumon	LC
Herpestes javanicus	LC
Herpestes naso	LC
Herpestes ochraceus	LC
Herpestes pulverulentus	LC
Herpestes sanguineus	LC
Herpestes semitorquatus	NT
Herpestes smithii	LC
Herpestes urva	LC
Herpestes vitticollis	LC
Hesperoptenus blanfordi	LC
Hesperoptenus doriae	DD
Hesperoptenus gaskelli	DD
Hesperoptenus tickelli	LC
Hesperoptenus tomesi	VU
Heterocephalus glaber	LC
Heterogeomys cherriei	LC
Heterogeomys dariensis	LC
Heterogeomys lanius	CR
Heterohyrax brucei	LC
Heteromys adspersus	LC
Heteromys anomalus	LC
Heteromys australis	LC
Heteromys desmarestianus	LC
Heteromys gaumeri	LC
Heteromys irroratus	LC
Heteromys nelsoni	EN
Heteromys oasicus	EN
Heteromys oresterus	LC
Heteromys pictus	LC
Heteromys salvini	LC
Heteromys spectabilis	EN
Heteromys teleus	VU
Hippocamelus antisensis	VU
Hippocamelus bisulcus	EN
Hippopotamus amphibius	VU
Hipposideros abae	LC
Hipposideros armiger	LC
Hipposideros ater	LC
Hipposideros atrox	LC
Hipposideros beatus	LC
Hipposideros bicolor	LC
Hipposideros boeadii	DD
Hipposideros breviceps	DD
Hipposideros caffer	LC
Hipposideros calcaratus	LC
Hipposideros camerunensis	DD
Hipposideros cervinus	LC
Hipposideros cineraceus	LC
Hipposideros commersoni	NT
Hipposideros coronatus	DD
Hipposideros corynophyllus	LC
Hipposideros coxi	EN
Hipposideros crumeniferus	DD
Hipposideros curtus	VU
Hipposideros cyclops	LC
Hipposideros demissus	VU
Hipposideros diadema	LC
Hipposideros dinops	DD
Hipposideros doriae	NT
Hipposideros durgadasi	VU
Hipposideros dyacorum	LC
Hipposideros edwardshilli	VU
Hipposideros einnaythu	DD
Hipposideros fuliginosus	LC
Hipposideros fulvus	LC
Hipposideros galeritus	LC
Hipposideros gigas	LC
Hipposideros grandis	LC
Hipposideros halophyllus	VU
Hipposideros hypophyllus	CR
Hipposideros inexpectatus	DD
Hipposideros inornatus	VU
Hipposideros jonesi	NT
Hipposideros khaokhouayensis	VU
Hipposideros khasiana	DD
Hipposideros lamottei	CR
Hipposideros lankadiva	LC
Hipposideros larvatus	LC
Hipposideros lekaguli	NT
Hipposideros lylei	LC
Hipposideros macrobullatus	DD
Hipposideros madurae	LC
Hipposideros maggietaylorae	LC
Hipposideros marisae	VU
Hipposideros megalotis	LC
Hipposideros muscinus	LC
Hipposideros nequam	DD
Hipposideros obscurus	LC
Hipposideros orbiculus	VU
Hipposideros papua	LC
Hipposideros pelingensis	NT
Hipposideros pomona	LC
Hipposideros pratti	LC
Hipposideros pygmaeus	LC
Hipposideros ridleyi	VU
Hipposideros rotalis	LC
Hipposideros ruber	LC
Hipposideros scutinares	VU
Hipposideros semoni	LC
Hipposideros sorenseni	VU
Hipposideros speoris	LC
Hipposideros stenotis	LC
Hipposideros sumbae	LC
Hipposideros tephrus	LC
Hipposideros thomensis	LC
Hipposideros turpis	NT
Hipposideros vittatus	NT
Hipposideros wollastoni	LC
Hippotragus equinus	LC
Hippotragus niger	LC
Histiotus alienus	DD
Histiotus humboldti	DD
Histiotus laephotis	LC
Histiotus macrotus	LC
Histiotus magellanicus	LC
Histiotus montanus	LC
Histiotus velatus	DD
Histriophoca fasciata	LC
Hodomys alleni	LC
Holochilus brasiliensis	LC
Holochilus chacarius	LC
Holochilus sciureus	LC
Homo sapiens	LC
Hoolock hoolock	EN
Hoolock leuconedys	VU
Hoplomys gymnurus	LC
Huetia leucorhina	DD
Hyaena hyaena	NT
Hybomys badius	EN
Hybomys basilii	EN
Hybomys eisentrauti	EN
Hybomys lunaris	VU
Hybomys planifrons	LC
Hybomys trivirgatus	LC
Hybomys univittatus	LC
Hydrictis maculicollis	NT
Hydrochoerus hydrochaeris	LC
Hydrochoerus isthmius	DD
Hydromys chrysogaster	LC
Hydromys hussoni	DD
Hydromys neobritannicus	DD
Hydromys ziegleri	DD
Hydropotes inermis	VU
Hydrurga leptonyx	LC
Hyemoschus aquaticus	LC
Hyladelphys kalinowskii	LC
Hylaeamys acritus	DD
Hylaeamys laticeps	NT
Hylaeamys megacephalus	LC
Hylaeamys oniscus	NT
Hylaeamys perenensis	LC
Hylaeamys tatei	DD
Hylaeamys yunganus	LC
Hylobates abbotti	EN
Hylobates agilis	EN
Hylobates albibarbis	EN
Hylobates funereus	EN
Hylobates klossii	EN
Hylobates lar	EN
Hylobates moloch	EN
Hylobates muelleri	EN
Hylobates pileatus	EN
Hylochoerus meinertzhageni	LC
Hylomys megalotis	DD
Hylomys parvus	VU
Hylomys suillus	LC
Hylomyscus aeta	LC
Hylomyscus alleni	LC
Hylomyscus anselli	LC
Hylomyscus arcimontensis	LC
Hylomyscus baeri	EN
Hylomyscus carillus	LC
Hylomyscus denniae	LC
Hylomyscus endorobae	LC
Hylomyscus grandis	EN
Hylomyscus heinrichorum	DD
Hylomyscus kerbispeterhansi	LC
Hylomyscus pamfi	DD
Hylomyscus parvus	LC
Hylomyscus stella	LC
Hylomyscus vulcanorum	LC
Hylomyscus walterverheyeni	LC
Hylonycteris underwoodi	LC
Hylopetes alboniger	LC
Hylopetes bartelsi	DD
Hylopetes nigripes	NT
Hylopetes phayrei	LC
Hylopetes platyurus	DD
Hylopetes sagitta	DD
Hylopetes sipora	EN
Hylopetes spadiceus	LC
Hylopetes winstoni	DD
Hyomys dammermani	DD
Hyomys goliath	LC
Hyorhinomys stuempkei	DD
Hyosciurus heinrichi	LC
Hyosciurus ileile	VU
Hyperacrius fertilis	NT
Hyperacrius wynnei	LC
Hyperoodon ampullatus	DD
Hyperoodon planifrons	LC
Hypogeomys antimena	EN
Hypsignathus monstrosus	LC
Hypsiprymnodon moschatus	LC
Hypsugo anthonyi	DD
Hypsugo bemainty	LC
Hypsugo joffrei	DD
Hypsugo kitcheneri	DD
Hypsugo lophurus	DD
Hypsugo macrotis	DD
Hypsugo savii	LC
Hypsugo vordermanni	DD
Hystrix africaeaustralis	LC
Hystrix brachyura	LC
Hystrix crassispinis	LC
Hystrix cristata	LC
Hystrix indica	LC
Hystrix javanica	LC
Hystrix pumila	VU
Hystrix sumatrae	LC
Ia io	LC
Ichneumia albicauda	LC
Ichthyomys hydrobates	NT
Ichthyomys pittieri	NT
Ichthyomys stolzmanni	DD
Ichthyomys tweedii	DD
Ictidomys mexicanus	LC
Ictidomys tridecemlineatus	LC
Ictonyx libycus	LC
Ictonyx striatus	LC
Idionycteris phyllotis	LC
Idiurus macrotis	LC
Idiurus zenkeri	LC
Indopacetus pacificus	DD
Indri indri	CR
Inia geoffrensis	EN
Iomys horsfieldii	LC
Iomys sipora	EN
Irenomys tarsalis	LC
Isoodon auratus	VU
Isoodon macrourus	LC
Isoodon obesulus	LC
Isothrix barbarabrownae	DD
Isothrix bistriata	LC
Isothrix negrensis	LC
Isothrix orinoci	DD
Isothrix pagurus	LC
Isothrix sinnamariensis	LC
Isthmomys flavidus	NT
Isthmomys pirrensis	LC
Jaculus blanfordi	LC
Jaculus jaculus	LC
Jaculus orientalis	LC
Jaculus thaleri	DD
Juliomys pictipes	LC
Juliomys rimofrons	NT
Juscelinomys huanchacae	DD
Kadarsanomys sodyi	EN
Kannabateomys amblyonyx	LC
Kerivoula africana	EN
Kerivoula agnella	DD
Kerivoula argentata	LC
Kerivoula cuprosa	DD
Kerivoula eriophora	DD
Kerivoula flora	VU
Kerivoula hardwickii	LC
Kerivoula intermedia	NT
Kerivoula kachinensis	LC
Kerivoula krauensis	DD
Kerivoula lanosa	LC
Kerivoula lenis	LC
Kerivoula minuta	NT
Kerivoula muscina	LC
Kerivoula myrella	DD
Kerivoula papillosa	LC
Kerivoula pellucida	NT
Kerivoula phalaena	LC
Kerivoula picta	LC
Kerivoula smithii	LC
Kerivoula titania	LC
Kerivoula whiteheadi	LC
Kerodon acrobata	DD
Kerodon rupestris	LC
Kobus ellipsiprymnus	LC
Kobus kob	LC
Kobus leche	NT
Kobus megaceros	EN
Kobus vardonii	NT
Kogia breviceps	DD
Kogia sima	DD
Komodomys rintjanus	VU
Kunsia tomentosus	LC
Laephotis angolensis	DD
Laephotis botswanae	LC
Laephotis namibensis	LC
Laephotis wintoni	LC
Lagenodelphis hosei	LC
Lagenorhynchus acutus	LC
Lagenorhynchus albirostris	LC
Lagenorhynchus australis	LC
Lagenorhynchus cruciger	LC
Lagenorhynchus obliquidens	LC
Lagenorhynchus obscurus	LC
Lagidium ahuacaense	DD
Lagidium viscacia	LC
Lagidium wolffsohni	DD
Lagorchestes conspicillatus	LC
Lagorchestes hirsutus	VU
Lagostomus maximus	LC
Lagostrophus fasciatus	VU
Lagothrix cana	EN
Lagothrix flavicauda	CR
Lagothrix lagotricha	VU
Lagothrix lugens	CR
Lagothrix poeppigii	VU
Lagurus lagurus	LC
Lama guanicoe	LC
Lamottemys okuensis	EN
Lampronycteris brachyotis	LC
Laonastes aenigmamus	LC
Lariscus hosei	LC
Lariscus insignis	LC
Lariscus niobe	DD
Lariscus obscurus	NT
Lasionycteris noctivagans	LC
Lasiopodomys brandtii	LC
Lasiopodomys fuscus	LC
Lasiopodomys mandarinus	LC
Lasiorhinus krefftii	CR
Lasiorhinus latifrons	NT
Lasiurus atratus	LC
Lasiurus blossevillii	LC
Lasiurus borealis	LC
Lasiurus castaneus	DD
Lasiurus cinereus	LC
Lasiurus degelidus	VU
Lasiurus ebenus	DD
Lasiurus ega	LC
Lasiurus egregius	DD
Lasiurus insularis	VU
Lasiurus intermedius	LC
Lasiurus minor	VU
Lasiurus pfeifferi	NT
Lasiurus salinae	DD
Lasiurus seminolus	LC
Lasiurus varius	LC
Lasiurus xanthinus	LC
Latidens salimalii	EN
Lavia frons	LC
Leggadina forresti	LC
Leggadina lakedownensis	LC
Leimacomys buettneri	DD
Lemmiscus curtatus	LC
Lemmus amurensis	LC
Lemmus lemmus	LC
Lemmus portenkoi	DD
Lemmus sibiricus	LC
Lemmus trimucronatus	LC
Lemniscomys barbarus	LC
Lemniscomys bellieri	LC
Lemniscomys griselda	LC
Lemniscomys hoogstraali	DD
Lemniscomys linulus	LC
Lemniscomys macculus	LC
Lemniscomys mittendorfi	LC
Lemniscomys rosalia	LC
Lemniscomys roseveari	DD
Lemniscomys striatus	LC
Lemniscomys zebra	LC
Lemur catta	EN
Lenomys meyeri	LC
Lenothrix canus	LC
Lenoxus apicalis	LC
Leontopithecus caissara	CR
Leontopithecus chrysomelas	EN
Leontopithecus chrysopygus	EN
Leontopithecus rosalia	EN
Leopardus colocolo	NT
Leopardus geoffroyi	LC
Leopardus guigna	VU
Leopardus guttulus	VU
Leopardus jacobita	EN
Leopardus pardalis	LC
Leopardus tigrinus	VU
Leopardus wiedii	NT
Leopoldamys ciliatus	LC
Leopoldamys diwangkarai	DD
Leopoldamys edwardsi	LC
Leopoldamys milleti	LC
Leopoldamys neilli	LC
Leopoldamys sabanus	LC
Leopoldamys siporanus	VU
Lepilemur aeeclis	VU
Lepilemur ahmansonorum	EN
Lepilemur ankaranensis	EN
Lepilemur betsileo	EN
Lepilemur dorsalis	VU
Lepilemur edwardsi	EN
Lepilemur fleuretae	CR
Lepilemur grewcockorum	EN
Lepilemur hollandorum	EN
Lepilemur hubbardorum	EN
Lepilemur jamesorum	CR
Lepilemur leucopus	EN
Lepilemur microdon	EN
Lepilemur milanoii	EN
Lepilemur mittermeieri	EN
Lepilemur mustelinus	NT
Lepilemur otto	EN
Lepilemur petteri	VU
Lepilemur randrianasoloi	EN
Lepilemur ruficaudatus	VU
Lepilemur sahamalazensis	CR
Lepilemur scottorum	EN
Lepilemur seali	VU
Lepilemur septentrionalis	CR
Lepilemur tymerlachsoni	CR
Lepilemur wrightae	EN
Leporillus conditor	NT
Leptailurus serval	LC
Leptomys arfakensis	DD
Leptomys elegans	LC
Leptomys ernstmayri	LC
Leptomys paulus	DD
Leptomys signatus	LC
Leptonychotes weddellii	LC
Leptonycteris curasoae	VU
Leptonycteris nivalis	EN
Leptonycteris yerbabuenae	NT
Lepus alleni	LC
Lepus americanus	LC
Lepus arcticus	LC
Lepus brachyurus	LC
Lepus californicus	LC
Lepus callotis	VU
Lepus capensis	LC
Lepus castroviejoi	VU
Lepus comus	LC
Lepus coreanus	LC
Lepus corsicanus	VU
Lepus europaeus	LC
Lepus fagani	LC
Lepus flavigularis	EN
Lepus granatensis	LC
Lepus habessinicus	LC
Lepus hainanus	EN
Lepus insularis	NT
Lepus mandshuricus	LC
Lepus nigricollis	LC
Lepus oiostolus	LC
Lepus othus	LC
Lepus peguensis	LC
Lepus saxatilis	LC
Lepus sinensis	LC
Lepus starcki	LC
Lepus tibetanus	LC
Lepus timidus	LC
Lepus tolai	LC
Lepus townsendii	LC
Lepus victoriae	LC
Lepus yarkandensis	NT
Lestodelphys halli	LC
Lestoros inca	LC
Liberiictis kuhni	VU
Lichonycteris degener	LC
Lichonycteris obscura	LC
Limnogale mergulus	VU
Limnomys bryophilus	LC
Limnomys sibuanus	LC
Lionycteris spurrelli	LC
Lipotes vexillifer	CR
Lissodelphis borealis	LC
Lissodelphis peronii	LC
Lissonycteris angolensis	LC
Litocranius walleri	NT
Lobodon carcinophaga	LC
Lonchophylla bokermanni	EN
Lonchophylla cadenai	DD
Lonchophylla chocoana	DD
Lonchophylla concava	LC
Lonchophylla dekeyseri	EN
Lonchophylla fornicata	DD
Lonchophylla handleyi	LC
Lonchophylla hesperia	NT
Lonchophylla mordax	NT
Lonchophylla orcesi	DD
Lonchophylla orienticollina	DD
Lonchophylla pattoni	DD
Lonchophylla peracchii	LC
Lonchophylla robusta	LC
Lonchophylla thomasi	LC
Lonchorhina aurita	LC
Lonchorhina fernandezi	EN
Lonchorhina inusitata	DD
Lonchorhina marinkellei	VU
Lonchorhina orinocensis	VU
Lonchothrix emiliae	LC
Lontra canadensis	LC
Lontra felina	EN
Lontra longicaudis	NT
Lontra provocax	EN
Lophiomys imhausi	LC
Lophocebus albigena	LC
Lophocebus aterrimus	NT
Lophostoma brasiliense	LC
Lophostoma carrikeri	LC
Lophostoma evotis	LC
Lophostoma kalkoae	DD
Lophostoma occidentalis	NT
Lophostoma schulzi	LC
Lophostoma silvicolum	LC
Lophuromys brevicaudus	NT
Lophuromys chercherensis	EN
Lophuromys chrysopus	LC
Lophuromys cinereus	DD
Lophuromys dieterleni	EN
Lophuromys eisentrauti	CR
Lophuromys flavopunctatus	LC
Lophuromys huttereri	LC
Lophuromys luteogaster	LC
Lophuromys machangui	DD
Lophuromys makundii	DD
Lophuromys medicaudatus	VU
Lophuromys melanonyx	VU
Lophuromys menageshae	DD
Lophuromys nudicaudus	LC
Lophuromys pseudosikapusi	EN
Lophuromys rahmi	NT
Lophuromys roseveari	LC
Lophuromys sabunii	DD
Lophuromys sikapusi	LC
Lophuromys simensis	LC
Lophuromys stanleyi	DD
Lophuromys woosnami	LC
Lorentzimys nouhuysi	LC
Loris lydekkerianus	LC
Loris tardigradus	EN
Loxodonta africana	VU
Loxodontomys micropus	LC
Loxodontomys pikumche	LC
Lundomys molitor	LC
Lutra lutra	NT
Lutra sumatrana	EN
Lutreolina crassicaudata	LC
Lutreolina massoia	LC
Lutrogale perspicillata	VU
Lycalopex culpaeus	LC
Lycalopex fulvipes	EN
Lycalopex griseus	LC
Lycalopex gymnocercus	LC
Lycalopex sechurae	NT
Lycalopex vetulus	LC
Lycaon pictus	EN
Lycaon pictus	EN
Lycaon pictus	EN
Lyncodon patagonicus	LC
Lynx canadensis	LC
Lynx lynx	LC
Lynx pardinus	EN
Lynx rufus	LC
Macaca arctoides	VU
Macaca assamensis	NT
Macaca cyclopis	LC
Macaca fascicularis	LC
Macaca fuscata	LC
Macaca hecki	VU
Macaca leonina	VU
Macaca maura	EN
Macaca mulatta	LC
Macaca munzala	EN
Macaca nemestrina	VU
Macaca nigra	CR
Macaca nigrescens	VU
Macaca ochreata	VU
Macaca pagensis	CR
Macaca radiata	LC
Macaca siberu	VU
Macaca silenus	EN
Macaca sinica	EN
Macaca sylvanus	EN
Macaca thibetana	NT
Macaca tonkeana	VU
Macroderma gigas	VU
Macrogalidia musschenbroekii	VU
Macroglossus minimus	LC
Macroglossus sobrinus	LC
Macrophyllum macrophyllum	LC
Macropus agilis	LC
Macropus antilopinus	LC
Macropus bernardus	NT
Macropus dorsalis	LC
Macropus eugenii	LC
Macropus fuliginosus	LC
Macropus giganteus	LC
Macropus irma	LC
Macropus parma	NT
Macropus parryi	LC
Macropus robustus	LC
Macropus rufogriseus	LC
Macropus rufus	LC
Macroscelides flavicaudatus	LC
Macroscelides micus	LC
Macroscelides proboscideus	LC
Macrotarsomys bastardi	LC
Macrotarsomys ingens	EN
Macrotarsomys petteri	DD
Macrotis lagotis	VU
Macrotus californicus	LC
Macrotus waterhousii	LC
Macruromys elegans	DD
Macruromys major	LC
Madoqua guentheri	LC
Madoqua kirkii	LC
Madoqua piacentinii	DD
Madoqua saltiana	LC
Madromys blanfordi	LC
Makalata didelphoides	LC
Makalata macrura	LC
Makalata obscura	DD
Malacomys cansdalei	LC
Malacomys edwardsi	LC
Malacomys longipes	LC
Malacothrix typica	LC
Mallomys aroaensis	LC
Mallomys gunung	EN
Mallomys istapantap	LC
Mallomys rothschildi	LC
Mammelomys lanosus	LC
Mammelomys rattoides	LC
Mandrillus leucophaeus	EN
Mandrillus sphinx	VU
Manis crassicaudata	EN
Manis culionensis	EN
Manis javanica	CR
Manis pentadactyla	CR
Margaretamys beccarii	VU
Margaretamys christinae	EN
Margaretamys elegans	NT
Margaretamys parvus	DD
Marmosa alstoni	LC
Marmosa andersoni	DD
Marmosa constantiae	LC
Marmosa demerarae	LC
Marmosa lepida	LC
Marmosa mexicana	LC
Marmosa murina	LC
Marmosa paraguayana	LC
Marmosa phaea	VU
Marmosa quichua	LC
Marmosa regina	LC
Marmosa robinsoni	LC
Marmosa rubra	DD
Marmosa tyleriana	DD
Marmosa xerophila	VU
Marmosops bishopi	LC
Marmosops caucae	LC
Marmosops cracens	DD
Marmosops creightoni	DD
Marmosops fuscatus	DD
Marmosops handleyi	CR
Marmosops impavidus	LC
Marmosops incanus	LC
Marmosops invictus	LC
Marmosops juninensis	VU
Marmosops neblina	LC
Marmosops noctivagus	LC
Marmosops ocellatus	LC
Marmosops pakaraimae	VU
Marmosops parvidens	LC
Marmosops paulensis	LC
Marmosops pinheiroi	LC
Marmota baibacina	LC
Marmota bobak	LC
Marmota broweri	LC
Marmota caligata	LC
Marmota camtschatica	LC
Marmota caudata	LC
Marmota flaviventris	LC
Marmota himalayana	LC
Marmota marmota	LC
Marmota menzbieri	VU
Marmota monax	LC
Marmota olympus	LC
Marmota sibirica	EN
Marmota vancouverensis	CR
Martes americana	LC
Martes flavigula	LC
Martes foina	LC
Martes gwatkinsii	VU
Martes martes	LC
Martes melampus	LC
Martes pennanti	LC
Martes zibellina	LC
Massoutiera mzabi	LC
Mastacomys fuscus	NT
Mastomys awashensis	LC
Mastomys coucha	LC
Mastomys erythroleucus	LC
Mastomys huberti	LC
Mastomys kollmannspergeri	LC
Mastomys natalensis	LC
Mastomys pernanus	DD
Mastomys shortridgei	LC
Maxomys alticola	LC
Maxomys baeodon	DD
Maxomys bartelsii	LC
Maxomys dollmani	DD
Maxomys hellwaldii	LC
Maxomys hylomyoides	DD
Maxomys inas	LC
Maxomys inflatus	VU
Maxomys moi	LC
Maxomys musschenbroekii	LC
Maxomys ochraceiventer	DD
Maxomys pagensis	VU
Maxomys panglima	LC
Maxomys rajah	VU
Maxomys surifer	LC
Maxomys tajuddinii	LC
Maxomys wattsi	EN
Maxomys whiteheadi	VU
Mazama americana	DD
Mazama bororo	VU
Mazama bricenii	VU
Mazama chunyi	VU
Mazama gouazoubira	LC
Mazama nana	VU
Mazama nemorivaga	LC
Mazama pandora	VU
Mazama rufina	VU
Mazama temama	DD
Megadendromus nikolausi	VU
Megaderma lyra	LC
Megaderma spasma	LC
Megadontomys cryophilus	EN
Megadontomys nelsoni	EN
Megadontomys thomasi	EN
Megaerops ecaudatus	LC
Megaerops kusnotoi	VU
Megaerops niphanae	LC
Megaerops wetmorei	VU
Megaloglossus azagnyi	LC
Megaloglossus woermanni	LC
Megaptera novaeangliae	LC
Megaptera novaeangliae	LC
Megaptera novaeangliae	LC
Megasorex gigas	LC
Melanomys caliginosus	LC
Melanomys robustulus	LC
Melanomys zunigae	CR
Melasmothrix naso	DD
Meles anakuma	LC
Meles leucurus	LC
Meles meles	LC
Mellivora capensis	LC
Melogale cucphuongensis	DD
Melogale everetti	EN
Melogale moschata	LC
Melogale orientalis	LC
Melogale personata	LC
Melomys aerosus	EN
Melomys arcium	DD
Melomys bannisteri	EN
Melomys bougainville	DD
Melomys burtoni	LC
Melomys capensis	LC
Melomys caurinus	EN
Melomys cervinipes	LC
Melomys cooperae	DD
Melomys dollmani	LC
Melomys fraterculus	CR
Melomys frigicola	LC
Melomys fulgens	DD
Melomys howi	DD
Melomys leucogaster	LC
Melomys lutillus	LC
Melomys matambuai	EN
Melomys obiensis	LC
Melomys paveli	DD
Melomys rufescens	LC
Melomys talaudium	EN
Melonycteris fardoulisi	LC
Melonycteris melanops	LC
Melonycteris woodfordi	LC
Melursus ursinus	VU
Menetes berdmorei	LC
Mephitis macroura	LC
Mephitis mephitis	LC
Meriones arimalius	LC
Meriones chengi	LC
Meriones crassus	LC
Meriones dahli	EN
Meriones grandis	LC
Meriones hurrianae	LC
Meriones libycus	LC
Meriones meridianus	LC
Meriones persicus	LC
Meriones rex	LC
Meriones sacramenti	VU
Meriones shawi	LC
Meriones tamariscinus	LC
Meriones tristrami	LC
Meriones unguiculatus	LC
Meriones vinogradovi	LC
Meriones zarudnyi	DD
Mesechinus dauuricus	LC
Mesechinus hughi	LC
Mesembriomys gouldii	VU
Mesembriomys macrurus	NT
Mesocapromys angelcabrerai	EN
Mesocapromys auritus	EN
Mesocapromys nanus	CR
Mesocapromys sanfelipensis	CR
Mesocricetus auratus	VU
Mesocricetus brandti	NT
Mesocricetus newtoni	NT
Mesocricetus raddei	LC
Mesomys hispidus	LC
Mesomys leniceps	DD
Mesomys occultus	LC
Mesomys stimulax	LC
Mesophylla macconnelli	LC
Mesoplodon bidens	DD
Mesoplodon bowdoini	DD
Mesoplodon carlhubbsi	DD
Mesoplodon densirostris	DD
Mesoplodon europaeus	DD
Mesoplodon ginkgodens	DD
Mesoplodon grayi	DD
Mesoplodon hectori	DD
Mesoplodon hotaula	DD
Mesoplodon layardii	DD
Mesoplodon mirus	DD
Mesoplodon perrini	DD
Mesoplodon peruvianus	DD
Mesoplodon stejnegeri	DD
Mesoplodon traversii	DD
Metachirus nudicaudatus	LC
Micaelamys granti	LC
Micaelamys namaquensis	LC
Mico acariensis	LC
Mico argentatus	LC
Mico chrysoleucos	LC
Mico emiliae	LC
Mico humeralifer	DD
Mico intermedius	LC
Mico leucippe	VU
Mico marcai	DD
Mico mauesi	LC
Mico melanurus	LC
Mico nigriceps	DD
Mico rondoni	VU
Mico saterei	LC
Microakodontomys transitorius	EN
Microcavia australis	LC
Microcavia niata	LC
Microcavia shiptoni	NT
Microcebus arnholdi	EN
Microcebus berthae	EN
Microcebus bongolavensis	EN
Microcebus danfossi	EN
Microcebus gerpi	CR
Microcebus griseorufus	LC
Microcebus jollyae	EN
Microcebus lehilahytsara	VU
Microcebus macarthurii	EN
Microcebus mamiratra	CR
Microcebus margotmarshae	EN
Microcebus marohita	CR
Microcebus mittermeieri	EN
Microcebus murinus	LC
Microcebus myoxinus	VU
Microcebus ravelobensis	EN
Microcebus rufus	VU
Microcebus sambiranensis	EN
Microcebus simmonsi	EN
Microcebus tavaratra	VU
Microdillus peeli	DD
Microdipodops megacephalus	LC
Microdipodops pallidus	LC
Microgale brevicaudata	LC
Microgale cowani	LC
Microgale dobsoni	LC
Microgale drouhardi	LC
Microgale dryas	VU
Microgale fotsifotsy	LC
Microgale gracilis	LC
Microgale grandidieri	LC
Microgale gymnorhyncha	LC
Microgale jenkinsae	EN
Microgale jobihely	EN
Microgale longicaudata	LC
Microgale majori	LC
Microgale monticola	VU
Microgale nasoloi	VU
Microgale parvula	LC
Microgale principula	LC
Microgale pusilla	LC
Microgale soricoides	LC
Microgale taiva	LC
Microgale talazaci	LC
Microgale thomasi	LC
Microhydromys argenteus	DD
Microhydromys richardsoni	DD
Micromys minutus	LC
Micronycteris brosseti	DD
Micronycteris buriri	DD
Micronycteris giovanniae	DD
Micronycteris hirsuta	LC
Micronycteris matses	DD
Micronycteris megalotis	LC
Micronycteris microtis	LC
Micronycteris minuta	LC
Micronycteris sanborni	LC
Micronycteris schmidtorum	LC
Micronycteris yatesi	DD
Microperoryctes aplini	VU
Microperoryctes longicauda	LC
Microperoryctes murina	VU
Microperoryctes papuensis	LC
Micropotamogale lamottei	VU
Micropotamogale ruwenzorii	LC
Micropteropus intermedius	DD
Micropteropus pusillus	LC
Microryzomys altissimus	LC
Microryzomys minutus	LC
Microsciurus alfari	LC
Microsciurus flaviventer	LC
Microsciurus mimulus	LC
Microsciurus santanderensis	DD
Microtus abbreviatus	LC
Microtus agrestis	LC
Microtus anatolicus	DD
Microtus arvalis	LC
Microtus bavaricus	CR
Microtus brachycercus	LC
Microtus breweri	VU
Microtus cabrerae	NT
Microtus californicus	LC
Microtus canicaudus	LC
Microtus chrotorrhinus	LC
Microtus clarkei	LC
Microtus daghestanicus	LC
Microtus dogramacii	LC
Microtus duodecimcostatus	LC
Microtus elbeyli	DD
Microtus evoronensis	DD
Microtus felteni	DD
Microtus fortis	LC
Microtus gerbei	LC
Microtus gregalis	LC
Microtus guatemalensis	NT
Microtus guentheri	LC
Microtus hyperboreus	LC
Microtus ilaeus	LC
Microtus irani	VU
Microtus kermanensis	DD
Microtus kikuchii	LC
Microtus levis	LC
Microtus liechtensteini	LC
Microtus limnophilus	LC
Microtus longicaudus	LC
Microtus lusitanicus	LC
Microtus majori	LC
Microtus maximowiczii	LC
Microtus mexicanus	LC
Microtus middendorffii	LC
Microtus miurus	LC
Microtus mongolicus	LC
Microtus montanus	LC
Microtus montebelli	LC
Microtus mujanensis	DD
Microtus multiplex	LC
Microtus nasarovi	DD
Microtus oaxacensis	EN
Microtus ochrogaster	LC
Microtus oeconomus	LC
Microtus oregoni	LC
Microtus paradoxus	LC
Microtus pennsylvanicus	LC
Microtus pinetorum	LC
Microtus qazvinensis	LC
Microtus quasiater	NT
Microtus richardsoni	LC
Microtus sachalinensis	LC
Microtus savii	LC
Microtus schelkovnikovi	LC
Microtus schidlovskii	LC
Microtus socialis	LC
Microtus subterraneus	LC
Microtus tatricus	LC
Microtus thomasi	LC
Microtus townsendii	LC
Microtus transcaspicus	LC
Microtus umbrosus	EN
Microtus xanthognathus	LC
Millardia gleadowi	LC
Millardia kathleenae	LC
Millardia kondana	CR
Millardia meltada	LC
Mimetillus moloneyi	LC
Mimon bennettii	LC
Mimon cozumelae	LC
Mindomys hammondi	EN
Miniopterus aelleni	LC
Miniopterus africanus	LC
Miniopterus ambohitrensis	LC
Miniopterus australis	LC
Miniopterus brachytragos	LC
Miniopterus egeri	LC
Miniopterus fraterculus	LC
Miniopterus fuscus	EN
Miniopterus gleni	LC
Miniopterus griffithsi	DD
Miniopterus griveaudi	DD
Miniopterus inflatus	LC
Miniopterus macrocneme	DD
Miniopterus maghrebensis	NT
Miniopterus magnater	LC
Miniopterus mahafaliensis	LC
Miniopterus majori	LC
Miniopterus manavi	LC
Miniopterus medius	LC
Miniopterus minor	DD
Miniopterus natalensis	LC
Miniopterus newtoni	DD
Miniopterus paululus	DD
Miniopterus petersoni	DD
Miniopterus pusillus	LC
Miniopterus robustior	EN
Miniopterus schreibersii	NT
Miniopterus shortridgei	DD
Miniopterus sororculus	LC
Miniopterus tristis	LC
Miopithecus ogouensis	LC
Miopithecus talapoin	LC
Mirimiri acrodonta	CR
Mirounga angustirostris	LC
Mirounga leonina	LC
Mirza coquereli	EN
Mirza zaza	EN
Mirzamys louiseae	LC
Mirzamys norahae	DD
Mogera etigo	EN
Mogera imaizumii	LC
Mogera insularis	LC
Mogera robusta	LC
Mogera tokudae	NT
Mogera uchidai	VU
Mogera wogura	LC
Molossops aequatorianus	EN
Molossops mattogrossensis	LC
Molossops neglectus	DD
Molossops temminckii	LC
Molossus alvarezi	DD
Molossus aztecus	LC
Molossus bondae	LC
Molossus coibensis	LC
Molossus currentium	LC
Molossus molossus	LC
Molossus pretiosus	LC
Molossus rufus	LC
Molossus sinaloae	LC
Monachus monachus	EN
Monachus monachus	EN
Monodelphis adusta	LC
Monodelphis americana	LC
Monodelphis brevicaudata	LC
Monodelphis dimidiata	LC
Monodelphis domestica	LC
Monodelphis emiliae	LC
Monodelphis glirina	LC
Monodelphis handleyi	DD
Monodelphis iheringi	DD
Monodelphis kunsi	LC
Monodelphis osgoodi	LC
Monodelphis palliolata	LC
Monodelphis peruviana	LC
Monodelphis reigi	VU
Monodelphis ronaldi	LC
Monodelphis scalops	LC
Monodelphis unistriata	CR
Monodon monoceros	LC
Monophyllus plethodon	LC
Monophyllus redmani	LC
Monticolomys koopmani	LC
Mops bakarii	DD
Mops brachypterus	LC
Mops condylurus	LC
Mops congicus	LC
Mops demonstrator	LC
Mops leucostigma	LC
Mops midas	LC
Mops mops	NT
Mops nanulus	LC
Mops niangarae	DD
Mops niveiventer	LC
Mops petersoni	NT
Mops sarasinorum	DD
Mops spurrelli	LC
Mops thersites	LC
Mops trevori	DD
Mormoops blainvillei	LC
Mormoops megalophylla	LC
Mormopterus acetabulosus	EN
Mormopterus beccarii	LC
Mormopterus cobourgianus	LC
Mormopterus doriae	DD
Mormopterus eleryi	NT
Mormopterus francoismoutoui	LC
Mormopterus halli	DD
Mormopterus jugularis	LC
Mormopterus kalinowskii	LC
Mormopterus kitcheneri	LC
Mormopterus lumsdenae	LC
Mormopterus minutus	VU
Mormopterus norfolkensis	VU
Mormopterus phrudus	VU
Mormopterus planiceps	LC
Mormopterus ridei	LC
Moschiola indica	LC
Moschiola kathygre	LC
Moschiola meminna	LC
Moschus anhuiensis	EN
Moschus berezovskii	EN
Moschus chrysogaster	EN
Moschus cupreus	EN
Moschus fuscus	EN
Moschus leucogaster	EN
Moschus moschiferus	VU
Mosia nigrescens	LC
Mungos gambianus	LC
Mungos mungo	LC
Mungotictis decemlineata	EN
Muntiacus atherodes	NT
Muntiacus crinifrons	VU
Muntiacus feae	DD
Muntiacus gongshanensis	DD
Muntiacus montanus	DD
Muntiacus muntjak	LC
Muntiacus puhoatensis	DD
Muntiacus putaoensis	DD
Muntiacus reevesi	LC
Muntiacus rooseveltorum	DD
Muntiacus truongsonensis	DD
Muntiacus vaginalis	LC
Muntiacus vuquangensis	CR
Murexia habbema	LC
Murexia longicaudata	LC
Murexia melanurus	LC
Murexia naso	LC
Murexia rothschildi	NT
Muriculus imberbis	LC
Murina aenea	VU
Murina aurata	LC
Murina balaensis	CR
Murina bicolor	LC
Murina cyclotis	LC
Murina florium	LC
Murina fusca	DD
Murina gracilis	LC
Murina harrisoni	LC
Murina hilgendorfi	LC
Murina huttoni	LC
Murina jaintiana	DD
Murina leucogaster	LC
Murina pluvialis	DD
Murina puta	NT
Murina recondita	LC
Murina rozendaali	VU
Murina ryukyuana	EN
Murina suilla	LC
Murina tenebrosa	CR
Murina tubinaris	LC
Murina ussuriensis	LC
Mus baoulei	LC
Mus booduga	LC
Mus bufo	LC
Mus callewaerti	DD
Mus caroli	LC
Mus cervicolor	LC
Mus cookii	LC
Mus crociduroides	DD
Mus cypriacus	LC
Mus famulus	EN
Mus fernandoni	EN
Mus fragilicauda	LC
Mus goundae	DD
Mus haussa	LC
Mus indutus	LC
Mus macedonicus	LC
Mus mahomet	LC
Mus mattheyi	LC
Mus mayori	VU
Mus minutoides	LC
Mus musculoides	LC
Mus musculus	LC
Mus neavei	DD
Mus oubanguii	DD
Mus pahari	LC
Mus phillipsi	LC
Mus platythrix	LC
Mus saxicola	LC
Mus setulosus	LC
Mus setzeri	LC
Mus shortridgei	LC
Mus sorella	LC
Mus spicilegus	LC
Mus spretus	LC
Mus tenellus	LC
Mus terricolor	LC
Mus triton	LC
Mus vulcani	LC
Muscardinus avellanarius	LC
Musonycteris harrisoni	VU
Musseromys anacuao	DD
Musseromys beneficus	DD
Musseromys gulantang	DD
Musseromys inopinatus	DD
Mustela africana	LC
Mustela altaica	NT
Mustela erminea	LC
Mustela eversmanii	LC
Mustela felipei	VU
Mustela frenata	LC
Mustela itatsi	NT
Mustela kathiah	LC
Mustela lutreola	CR
Mustela lutreolina	LC
Mustela nigripes	EN
Mustela nivalis	LC
Mustela nudipes	LC
Mustela putorius	LC
Mustela russelliana	DD
Mustela sibirica	LC
Mustela strigidorsa	LC
Mustela subpalmata	LC
Mustela tonkinensis	DD
Mydaus javanensis	LC
Mydaus marchei	LC
Mylomys dybowskii	LC
Mylomys rex	DD
Myocastor coypus	LC
Myodes andersoni	LC
Myodes californicus	LC
Myodes centralis	LC
Myodes gapperi	LC
Myodes glareolus	LC
Myodes regulus	LC
Myodes rex	LC
Myodes rufocanus	LC
Myodes rutilus	LC
Myodes shanseius	LC
Myodes smithii	LC
Myoictis leucura	DD
Myoictis melas	LC
Myoictis wallacei	LC
Myoictis wavicus	DD
Myomimus personatus	DD
Myomimus roachi	VU
Myomimus setzeri	DD
Myomyscus angolensis	LC
Myomyscus brockmani	LC
Myomyscus verreauxii	LC
Myomyscus yemeni	DD
Myonycteris brachycephala	EN
Myonycteris leptodon	LC
Myonycteris relicta	LC
Myonycteris torquata	LC
Myoprocta acouchy	LC
Myoprocta pratti	LC
Myopterus daubentonii	DD
Myopterus whitleyi	LC
Myopus schisticolor	LC
Myosciurus pumilio	LC
Myosorex babaulti	LC
Myosorex blarina	EN
Myosorex bururiensis	VU
Myosorex cafer	LC
Myosorex eisentrauti	CR
Myosorex geata	EN
Myosorex gnoskei	EN
Myosorex jejei	VU
Myosorex kabogoensis	DD
Myosorex kihaulei	EN
Myosorex longicaudatus	VU
Myosorex okuensis	VU
Myosorex rumpii	EN
Myosorex schalleri	DD
Myosorex sclateri	NT
Myosorex tenuis	DD
Myosorex varius	LC
Myosorex zinki	LC
Myospalax aspalax	LC
Myospalax myospalax	LC
Myospalax psilurus	LC
Myotis adversus	LC
Myotis aelleni	DD
Myotis albescens	LC
Myotis alcathoe	DD
Myotis altarium	LC
Myotis anjouanensis	DD
Myotis annamiticus	DD
Myotis annectans	LC
Myotis atacamensis	EN
Myotis ater	LC
Myotis aurascens	LC
Myotis auriculus	LC
Myotis australis	DD
Myotis austroriparius	LC
Myotis bechsteinii	NT
Myotis blythii	LC
Myotis bocagii	LC
Myotis bombinus	NT
Myotis borneoensis	DD
Myotis brandtii	LC
Myotis bucharensis	DD
Myotis californicus	LC
Myotis capaccinii	VU
Myotis chiloensis	LC
Myotis chinensis	LC
Myotis ciliolabrum	LC
Myotis cobanensis	DD
Myotis csorbai	DD
Myotis dasycneme	NT
Myotis daubentonii	LC
Myotis davidii	LC
Myotis dieteri	DD
Myotis diminutus	DD
Myotis dinellii	LC
Myotis dominicensis	VU
Myotis elegans	LC
Myotis emarginatus	LC
Myotis escalerai	LC
Myotis evotis	LC
Myotis federatus	DD
Myotis fimbriatus	LC
Myotis findleyi	EN
Myotis formosus	LC
Myotis fortidens	LC
Myotis frater	DD
Myotis gomantongensis	LC
Myotis goudoti	LC
Myotis grisescens	VU
Myotis hajastanicus	CR
Myotis hasseltii	LC
Myotis hermani	DD
Myotis horsfieldii	LC
Myotis ikonnikovi	LC
Myotis insularum	DD
Myotis izecksohni	DD
Myotis keaysi	LC
Myotis keenii	LC
Myotis laniger	LC
Myotis lavali	LC
Myotis leibii	EN
Myotis levis	LC
Myotis longipes	DD
Myotis lucifugus	EN
Myotis macrodactylus	LC
Myotis macropus	LC
Myotis macrotarsus	NT
Myotis martiniquensis	NT
Myotis melanorhinus	LC
Myotis moluccarum	LC
Myotis montivagus	LC
Myotis morrisi	DD
Myotis muricola	LC
Myotis myotis	LC
Myotis mystacinus	LC
Myotis nattereri	LC
Myotis nesopolus	LC
Myotis nigricans	LC
Myotis nipalensis	LC
Myotis nyctor	VU
Myotis occultus	LC
Myotis oreias	DD
Myotis oxyotus	LC
Myotis peninsularis	EN
Myotis pequinius	LC
Myotis peytoni	DD
Myotis pilosus	NT
Myotis planiceps	EN
Myotis pruinosus	EN
Myotis punicus	DD
Myotis ridleyi	NT
Myotis riparius	LC
Myotis rosseti	LC
Myotis ruber	NT
Myotis rufopictus	DD
Myotis schaubi	DD
Myotis scotti	VU
Myotis secundus	LC
Myotis septentrionalis	NT
Myotis sicarius	VU
Myotis siligorensis	LC
Myotis simus	DD
Myotis sodalis	NT
Myotis soror	DD
Myotis stalkeri	DD
Myotis thysanodes	LC
Myotis tricolor	LC
Myotis velifer	LC
Myotis vivesi	VU
Myotis volans	LC
Myotis welwitschii	LC
Myotis yanbarensis	CR
Myotis yumanensis	LC
Myrmecobius fasciatus	EN
Myrmecophaga tridactyla	VU
Mysateles melanurus	VU
Mysateles prehensilis	NT
Mystacina robusta	CR
Mystacina tuberculata	VU
Mystromys albicaudatus	VU
Myzopoda aurita	LC
Myzopoda schliemanni	LC
Naemorhedus baileyi	VU
Naemorhedus caudatus	VU
Naemorhedus goral	NT
Naemorhedus griseus	VU
Nandinia binotata	LC
Nanger dama	CR
Nanger granti	LC
Nanger soemmerringii	VU
Nannosciurus melanotis	LC
Nannospalax ehrenbergi	DD
Nannospalax leucodon	DD
Nannospalax xanthodon	DD
Nanonycteris veldkampii	LC
Napaeozapus insignis	LC
Nasalis larvatus	EN
Nasua narica	LC
Nasua nasua	LC
Nasuella meridensis	EN
Nasuella olivacea	NT
Natalus espiritosantensis	NT
Natalus jamaicensis	CR
Natalus major	NT
Natalus mexicanus	LC
Natalus primus	VU
Natalus stramineus	LC
Natalus tumidirostris	LC
Neacomys dubosti	LC
Neacomys guianae	LC
Neacomys minutus	LC
Neacomys musseri	LC
Neacomys paracou	LC
Neacomys pictus	DD
Neacomys spinosus	LC
Neacomys tenuipes	LC
Neamblysomus gunningi	EN
Neamblysomus julianae	EN
Neamblysomus julianae	EN
Necromys amoenus	LC
Necromys benefactus	LC
Necromys lactens	LC
Necromys lasiurus	LC
Necromys lenguarum	LC
Necromys obscurus	NT
Necromys punctulatus	DD
Necromys temchuki	LC
Necromys urichi	LC
Nectogale elegans	LC
Nectomys apicalis	LC
Nectomys grandis	DD
Nectomys palmipes	LC
Nectomys rattus	LC
Nectomys squamipes	LC
Nelsonia goldmani	EN
Nelsonia neotomodon	NT
Neodon forresti	DD
Neodon irene	LC
Neodon juldaschi	LC
Neodon linzhiensis	DD
Neodon sikimensis	LC
Neofelis diardi	VU
Neofelis nebulosa	VU
Neofiber alleni	LC
Neohylomys hainanensis	EN
Neomicroxus bogotensis	LC
Neomicroxus latebricola	EN
Neomonachus schauinslandi	EN
Neomys anomalus	LC
Neomys fodiens	LC
Neomys teres	LC
Neonycteris pusilla	DD
Neophascogale lorentzii	LC
Neophoca cinerea	EN
Neophocaena asiaeorientalis	EN
Neophocaena phocaenoides	VU
Neopteryx frosti	EN
Neoromicia brunnea	NT
Neoromicia capensis	LC
Neoromicia flavescens	DD
Neoromicia guineensis	LC
Neoromicia helios	DD
Neoromicia isabella	DD
Neoromicia malagasyensis	VU
Neoromicia matroka	LC
Neoromicia melckorum	DD
Neoromicia nana	LC
Neoromicia rendalli	LC
Neoromicia robertsi	DD
Neoromicia roseveari	EN
Neoromicia somalica	LC
Neoromicia tenuipinnis	LC
Neoromicia zuluensis	LC
Neotamias alpinus	LC
Neotamias amoenus	LC
Neotamias bulleri	VU
Neotamias canipes	LC
Neotamias cinereicollis	LC
Neotamias dorsalis	LC
Neotamias durangae	LC
Neotamias merriami	LC
Neotamias minimus	LC
Neotamias obscurus	LC
Neotamias ochrogenys	LC
Neotamias palmeri	EN
Neotamias panamintinus	LC
Neotamias quadrimaculatus	LC
Neotamias quadrivittatus	LC
Neotamias ruficaudus	LC
Neotamias rufus	LC
Neotamias senex	LC
Neotamias siskiyou	LC
Neotamias sonomae	LC
Neotamias speciosus	LC
Neotamias townsendii	LC
Neotamias umbrinus	LC
Neotetracus sinensis	LC
Neotoma albigula	LC
Neotoma angustapalata	EN
Neotoma bryanti	LC
Neotoma chrysomelas	LC
Neotoma cinerea	LC
Neotoma devia	LC
Neotoma floridana	LC
Neotoma fuscipes	LC
Neotoma goldmani	LC
Neotoma insularis	DD
Neotoma lepida	LC
Neotoma leucodon	LC
Neotoma macrotis	LC
Neotoma magister	NT
Neotoma mexicana	LC
Neotoma micropus	LC
Neotoma nelsoni	CR
Neotoma palatina	VU
Neotoma phenax	NT
Neotoma stephensi	LC
Neotomodon alstoni	LC
Neotomys ebriosus	LC
Neotragus batesi	LC
Neotragus pygmaeus	LC
Neovison vison	LC
Nephelomys albigularis	LC
Nephelomys auriventer	LC
Nephelomys caracolus	LC
Nephelomys devius	LC
Nephelomys keaysi	LC
Nephelomys levipes	LC
Nephelomys meridensis	LC
Nesokia bunnii	EN
Nesokia indica	LC
Nesolagus netscheri	DD
Nesolagus timminsi	EN
Nesomys audeberti	LC
Nesomys lambertoni	EN
Nesomys rufus	LC
Nesoromys ceramicus	EN
Nesoryzomys fernandinae	VU
Nesoryzomys narboroughi	VU
Nesoryzomys swarthi	VU
Nesotragus moschatus	LC
Neurotrichus gibbsii	LC
Neusticomys ferreirai	DD
Neusticomys monticolus	LC
Neusticomys mussoi	VU
Neusticomys oyapocki	DD
Neusticomys peruviensis	LC
Neusticomys venezuelae	VU
Nilgiritragus hylocrius	EN
Nilopegamys plumbeus	CR
Ningaui ridei	LC
Ningaui timealeyi	LC
Ningaui yvonneae	LC
Niviventer andersoni	LC
Niviventer brahma	LC
Niviventer cameroni	VU
Niviventer confucianus	LC
Niviventer coninga	LC
Niviventer cremoriventer	LC
Niviventer culturatus	LC
Niviventer eha	LC
Niviventer excelsior	LC
Niviventer fraternus	LC
Niviventer fulvescens	LC
Niviventer hinpoon	EN
Niviventer langbianis	LC
Niviventer lepturus	LC
Niviventer niviventer	LC
Niviventer rapit	LC
Niviventer tenaster	LC
Noctilio albiventris	LC
Noctilio leporinus	LC
Nomascus concolor	CR
Nomascus gabriellae	EN
Nomascus hainanus	CR
Nomascus leucogenys	CR
Nomascus nasutus	CR
Nomascus siki	EN
Notiomys edwardsii	LC
Notiosorex cockrumi	LC
Notiosorex crawfordi	LC
Notiosorex evotis	LC
Notiosorex villai	VU
Notocitellus adocetus	LC
Notocitellus annulatus	LC
Notomys alexis	LC
Notomys aquilo	EN
Notomys cervinus	NT
Notomys fuscus	VU
Notomys mitchellii	LC
Notopteris macdonaldi	VU
Notopteris neocaledonica	VU
Notoryctes caurinus	LC
Notoryctes typhlops	LC
Nyctalus aviator	NT
Nyctalus azoreum	VU
Nyctalus furvus	VU
Nyctalus lasiopterus	VU
Nyctalus leisleri	LC
Nyctalus montanus	LC
Nyctalus noctula	LC
Nyctalus plancyi	LC
Nyctereutes procyonoides	LC
Nycteris arge	LC
Nycteris aurita	LC
Nycteris gambiensis	LC
Nycteris grandis	LC
Nycteris hispida	LC
Nycteris intermedia	LC
Nycteris javanica	VU
Nycteris macrotis	LC
Nycteris madagascariensis	DD
Nycteris major	DD
Nycteris nana	LC
Nycteris parisii	DD
Nycteris thebaica	LC
Nycteris tragata	NT
Nycteris vinsoni	DD
Nycteris woodi	LC
Nycticebus bengalensis	VU
Nycticebus coucang	VU
Nycticebus javanicus	CR
Nycticebus menagensis	VU
Nycticebus pygmaeus	VU
Nycticeinops schlieffeni	LC
Nycticeius aenobarbus	DD
Nycticeius cubanus	NT
Nycticeius humeralis	LC
Nyctiellus lepidus	LC
Nyctimene aello	LC
Nyctimene albiventer	LC
Nyctimene cephalotes	LC
Nyctimene certans	LC
Nyctimene cyclotis	DD
Nyctimene draconilla	DD
Nyctimene keasti	VU
Nyctimene major	LC
Nyctimene malaitensis	LC
Nyctimene masalai	DD
Nyctimene minutus	VU
Nyctimene rabori	EN
Nyctimene robinsoni	LC
Nyctimene sanctacrucis	DD
Nyctimene vizcaccia	LC
Nyctinomops aurispinosus	LC
Nyctinomops femorosaccus	LC
Nyctinomops laticaudatus	LC
Nyctinomops macrotis	LC
Nyctomys sumichrasti	LC
Nyctophilus arnhemensis	LC
Nyctophilus bifax	LC
Nyctophilus geoffroyi	LC
Nyctophilus gouldi	LC
Nyctophilus heran	DD
Nyctophilus howensis	CR
Nyctophilus microdon	DD
Nyctophilus microtis	LC
Nyctophilus nebulosus	CR
Nyctophilus sherrini	DD
Nyctophilus shirleyae	DD
Nyctophilus walkeri	LC
Ochotona alpina	LC
Ochotona argentata	EN
Ochotona cansus	LC
Ochotona collaris	LC
Ochotona coreana	DD
Ochotona curzoniae	LC
Ochotona dauurica	LC
Ochotona erythrotis	LC
Ochotona forresti	LC
Ochotona gloveri	LC
Ochotona hoffmanni	EN
Ochotona hyperborea	LC
Ochotona iliensis	EN
Ochotona koslowi	EN
Ochotona ladacensis	LC
Ochotona macrotis	LC
Ochotona mantchurica	LC
Ochotona nubrica	LC
Ochotona opaca	LC
Ochotona pallasii	LC
Ochotona princeps	LC
Ochotona pusilla	LC
Ochotona roylei	LC
Ochotona rufescens	LC
Ochotona rutila	LC
Ochotona syrinx	LC
Ochotona thibetana	LC
Ochotona thomasi	LC
Ochotona turuchanensis	LC
Ochrotomys nuttalli	LC
Octodon bridgesi	VU
Octodon degus	LC
Octodon lunatus	NT
Octodon pacificus	CR
Octodontomys gliroides	LC
Octomys mimax	LC
Odobenus rosmarus	VU
Odocoileus hemionus	LC
Odocoileus virginianus	LC
Oecomys auyantepui	LC
Oecomys bicolor	LC
Oecomys catherinae	LC
Oecomys cleberi	DD
Oecomys concolor	LC
Oecomys flavicans	LC
Oecomys mamorae	LC
Oecomys paricola	DD
Oecomys phaeotis	LC
Oecomys rex	LC
Oecomys roberti	LC
Oecomys rutilus	LC
Oecomys speciosus	LC
Oecomys superans	LC
Oecomys trinitatis	LC
Oenomys hypoxanthus	LC
Oenomys ornatus	DD
Okapia johnstoni	EN
Olallamys albicauda	DD
Olallamys edax	DD
Oligoryzomys andinus	LC
Oligoryzomys arenalis	LC
Oligoryzomys brendae	DD
Oligoryzomys chacoensis	LC
Oligoryzomys delticola	LC
Oligoryzomys destructor	LC
Oligoryzomys eliurus	LC
Oligoryzomys flavescens	LC
Oligoryzomys fornesi	LC
Oligoryzomys fulvescens	LC
Oligoryzomys griseolus	LC
Oligoryzomys longicaudatus	LC
Oligoryzomys magellanicus	LC
Oligoryzomys microtis	LC
Oligoryzomys moojeni	DD
Oligoryzomys nigripes	LC
Oligoryzomys rupestris	DD
Oligoryzomys stramineus	LC
Oligoryzomys vegetus	LC
Ommatophoca rossii	LC
Ondatra zibethicus	LC
Onychogalea fraenata	VU
Onychogalea unguifera	LC
Onychomys arenicola	LC
Onychomys leucogaster	LC
Onychomys torridus	LC
Orcaella brevirostris	EN
Orcaella brevirostris	EN
Orcaella brevirostris	EN
Orcaella brevirostris	EN
Orcaella brevirostris	EN
Orcaella brevirostris	EN
Orcaella brevirostris	EN
Orcaella heinsohni	VU
Orcinus orca	DD
Oreamnos americanus	LC
Oreoryzomys balneator	DD
Oreotragus oreotragus	LC
Ornithorhynchus anatinus	NT
Orthogeomys cavator	LC
Orthogeomys cuniculus	DD
Orthogeomys grandis	LC
Orthogeomys heterodus	LC
Orthogeomys hispidus	LC
Orthogeomys underwoodi	LC
Orycteropus afer	LC
Oryctolagus cuniculus	NT
Oryx beisa	EN
Oryx gazella	LC
Oryx leucoryx	VU
Oryzomys couesi	LC
Oryzomys dimidiatus	DD
Oryzomys gorgasi	EN
Oryzomys palustris	LC
Oryzorictes hova	LC
Oryzorictes tetradactylus	DD
Osgoodomys banderanus	LC
Otaria byronia	LC
Otocolobus manul	NT
Otocyon megalotis	LC
Otolemur crassicaudatus	LC
Otolemur garnettii	LC
Otomops formosus	DD
Otomops harrisoni	VU
Otomops johnstonei	DD
Otomops madagascariensis	LC
Otomops martiensseni	NT
Otomops papuensis	DD
Otomops secundus	DD
Otomops wroughtoni	DD
Otomys anchietae	LC
Otomys angoniensis	LC
Otomys auratus	NT
Otomys barbouri	EN
Otomys burtoni	EN
Otomys cuanzensis	LC
Otomys dartmouthi	DD
Otomys denti	LC
Otomys irroratus	LC
Otomys karoensis	LC
Otomys lacustris	VU
Otomys laminatus	NT
Otomys occidentalis	VU
Otomys sloggetti	LC
Otomys tropicalis	LC
Otomys typus	LC
Otomys unisulcatus	LC
Otonycteris hemprichii	LC
Otonycteris leucophaea	DD
Otonyctomys hatti	LC
Otopteropus cartilagonodus	LC
Otospermophilus beecheyi	LC
Otospermophilus variegatus	LC
Ototylomys phyllotis	LC
Ourebia ourebi	LC
Ovibos moschatus	LC
Ovis ammon	NT
Ovis canadensis	LC
Ovis dalli	LC
Ovis nivicola	LC
Ovis orientalis	VU
Oxymycterus amazonicus	LC
Oxymycterus angularis	LC
Oxymycterus caparoae	LC
Oxymycterus dasytrichus	LC
Oxymycterus delator	LC
Oxymycterus hiska	LC
Oxymycterus hispidus	LC
Oxymycterus hucucha	EN
Oxymycterus inca	LC
Oxymycterus josei	NT
Oxymycterus nasutus	LC
Oxymycterus paramensis	LC
Oxymycterus quaestor	LC
Oxymycterus roberti	LC
Oxymycterus rufus	LC
Oxymycterus wayku	VU
Ozimops loriae	DD
Ozimops petersi	LC
Ozotoceros bezoarticus	NT
Pachyuromys duprasi	LC
Pagophilus groenlandicus	LC
Paguma larvata	LC
Palawanomys furvus	LC
Pan paniscus	EN
Pan troglodytes	EN
Panthera leo	VU
Panthera leo	VU
Panthera onca	NT
Panthera pardus	VU
Panthera tigris	EN
Panthera uncia	VU
Pantholops hodgsonii	NT
Papagomys armandvillei	NT
Papio anubis	LC
Papio cynocephalus	LC
Papio hamadryas	LC
Papio kindae	LC
Papio papio	NT
Papio ursinus	LC
Pappogeomys bulleri	LC
Paracrocidura graueri	DD
Paracrocidura maxima	LC
Paracrocidura schoutedeni	LC
Paracynictis selousi	LC
Paradipus ctenodactylus	LC
Paradoxurus hermaphroditus	LC
Paradoxurus jerdoni	LC
Paradoxurus zeylonensis	LC
Paraechinus aethiopicus	LC
Paraechinus hypomelas	LC
Paraechinus micropus	LC
Paraechinus nudiventris	LC
Parahyaena brunnea	NT
Parahydromys asper	LC
Paraleptomys rufilatus	EN
Paraleptomys wilhelmina	DD
Paramelomys gressitti	EN
Paramelomys levipes	LC
Paramelomys lorentzii	LC
Paramelomys mollis	LC
Paramelomys moncktoni	LC
Paramelomys naso	LC
Paramelomys platyops	LC
Paramelomys rubex	LC
Paramelomys steini	DD
Parantechinus apicalis	EN
Paranyctimene raptor	LC
Paranyctimene tenax	LC
Parascalops breweri	LC
Parascaptor leucura	LC
Parastrellus hesperus	LC
Paratriaenops auritus	VU
Paratriaenops furculus	LC
Paratriaenops pauliani	DD
Paraxerus alexandri	LC
Paraxerus boehmi	LC
Paraxerus cepapi	LC
Paraxerus cooperi	DD
Paraxerus flavovittis	LC
Paraxerus lucifer	DD
Paraxerus ochraceus	LC
Paraxerus palliatus	LC
Paraxerus poensis	LC
Paraxerus vexillarius	NT
Paraxerus vincenti	EN
Pardofelis marmorata	NT
Paremballonura atrata	LC
Paremballonura tiavato	LC
Parotomys brantsii	LC
Parotomys littledalei	LC
Paruromys dominator	LC
Pattonomys carrikeri	DD
Pattonomys flavidus	DD
Pattonomys occasius	DD
Pattonomys punctatus	DD
Pattonomys semivillosus	LC
Paucidentomys vermidax	DD
Paulamys naso	EN
Pecari tajacu	LC
Pectinator spekei	LC
Pedetes capensis	LC
Pedetes surdaster	LC
Pelea capreolus	NT
Pelomys campanae	LC
Pelomys fallax	LC
Pelomys hopkinsi	DD
Pelomys isseli	NT
Pelomys minor	LC
Pentalagus furnessi	EN
Penthetor lucasi	LC
Peponocephala electra	LC
Perameles bougainville	VU
Perameles gunnii	VU
Perameles nasuta	LC
Perimyotis subflavus	VU
Perodicticus edwardsi	LC
Perodicticus ibeanus	LC
Perodicticus potto	LC
Perognathus alticola	VU
Perognathus amplus	LC
Perognathus fasciatus	LC
Perognathus flavescens	LC
Perognathus flavus	LC
Perognathus inornatus	LC
Perognathus longimembris	LC
Perognathus merriami	LC
Perognathus parvus	LC
Peromyscus attwateri	LC
Peromyscus aztecus	LC
Peromyscus beatae	LC
Peromyscus boylii	LC
Peromyscus bullatus	CR
Peromyscus californicus	LC
Peromyscus caniceps	CR
Peromyscus crinitus	LC
Peromyscus dickeyi	CR
Peromyscus difficilis	LC
Peromyscus eremicus	LC
Peromyscus eva	LC
Peromyscus fraterculus	LC
Peromyscus furvus	DD
Peromyscus gossypinus	LC
Peromyscus grandis	NT
Peromyscus gratus	LC
Peromyscus guardia	CR
Peromyscus guatemalensis	LC
Peromyscus gymnotis	LC
Peromyscus hooperi	LC
Peromyscus hylocetes	LC
Peromyscus interparietalis	CR
Peromyscus keeni	LC
Peromyscus leucopus	LC
Peromyscus levipes	LC
Peromyscus madrensis	EN
Peromyscus maniculatus	LC
Peromyscus mayensis	CR
Peromyscus megalops	LC
Peromyscus mekisturus	CR
Peromyscus melanocarpus	EN
Peromyscus melanophrys	LC
Peromyscus melanotis	LC
Peromyscus melanurus	EN
Peromyscus merriami	LC
Peromyscus mexicanus	LC
Peromyscus nasutus	LC
Peromyscus ochraventer	EN
Peromyscus pectoralis	LC
Peromyscus perfulvus	LC
Peromyscus polionotus	LC
Peromyscus polius	NT
Peromyscus pseudocrinitus	CR
Peromyscus sagax	DD
Peromyscus schmidlyi	LC
Peromyscus sejugis	EN
Peromyscus simulus	VU
Peromyscus slevini	CR
Peromyscus spicilegus	LC
Peromyscus stephani	CR
Peromyscus stirtoni	LC
Peromyscus truei	LC
Peromyscus winkelmanni	EN
Peromyscus yucatanicus	LC
Peromyscus zarhynchus	VU
Peropteryx kappleri	LC
Peropteryx leucoptera	LC
Peropteryx macrotis	LC
Peropteryx pallidoptera	DD
Peropteryx trinitatis	DD
Peroryctes broadbenti	EN
Peroryctes raffrayana	LC
Petaurillus emiliae	DD
Petaurillus hosei	DD
Petaurillus kinlochii	DD
Petaurista alborufus	LC
Petaurista elegans	LC
Petaurista leucogenys	LC
Petaurista magnificus	LC
Petaurista mechukaensis	DD
Petaurista mishmiensis	NT
Petaurista nobilis	NT
Petaurista petaurista	LC
Petaurista philippensis	LC
Petaurista xanthotis	LC
Petauroides volans	VU
Petaurus abidi	CR
Petaurus australis	NT
Petaurus biacensis	LC
Petaurus breviceps	LC
Petaurus gracilis	EN
Petaurus norfolcensis	LC
Petinomys crinitus	LC
Petinomys fuscocapillus	LC
Petinomys genibarbis	VU
Petinomys hageni	DD
Petinomys lugens	VU
Petinomys mindanensis	LC
Petinomys setosus	VU
Petinomys vordermanni	VU
Petrodromus tetradactylus	LC
Petrogale assimilis	LC
Petrogale brachyotis	LC
Petrogale burbidgei	NT
Petrogale coenensis	NT
Petrogale concinna	EN
Petrogale godmani	NT
Petrogale herberti	LC
Petrogale inornata	LC
Petrogale lateralis	VU
Petrogale mareeba	NT
Petrogale penicillata	VU
Petrogale persephone	EN
Petrogale purpureicollis	NT
Petrogale rothschildi	LC
Petrogale sharmani	VU
Petrogale xanthopus	NT
Petromus typicus	LC
Petromyscus barbouri	LC
Petromyscus collinus	LC
Petromyscus monticularis	LC
Petromyscus shortridgei	LC
Petropseudes dahli	LC
Phacochoerus aethiopicus	LC
Phacochoerus africanus	LC
Phaenomys ferrugineus	EN
Phaiomys leucurus	LC
Phalanger alexandrae	EN
Phalanger carmelitae	LC
Phalanger gymnotis	LC
Phalanger intercastellanus	LC
Phalanger lullulae	EN
Phalanger matabiru	VU
Phalanger matanim	CR
Phalanger mimicus	LC
Phalanger orientalis	LC
Phalanger ornatus	LC
Phalanger rothschildi	LC
Phalanger sericeus	LC
Phalanger vestitus	LC
Phaner electromontis	EN
Phaner furcifer	VU
Phaner pallescens	EN
Phaner parienti	EN
Pharotis imogene	CR
Phascogale calura	NT
Phascogale pirata	VU
Phascogale tapoatafa	NT
Phascolarctos cinereus	VU
Phascolosorex doriae	LC
Phascolosorex dorsalis	LC
Phataginus tetradactyla	VU
Phataginus tricuspis	VU
Phenacomys intermedius	LC
Phenacomys ungava	LC
Philander andersoni	LC
Philander deltae	LC
Philander frenatus	LC
Philander mcilhennyi	LC
Philander mondolfii	LC
Philander olrogi	DD
Philander opossum	LC
Philantomba maxwellii	LC
Philantomba monticola	LC
Philantomba walteri	DD
Philetor brachypterus	LC
Phloeomys cumingi	LC
Phloeomys pallidus	LC
Phoca largha	LC
Phoca vitulina	LC
Phocarctos hookeri	EN
Phocoena dioptrica	LC
Phocoena phocoena	LC
Phocoena phocoena	LC
Phocoena sinus	CR
Phocoena spinipinnis	NT
Phocoenoides dalli	LC
Phodopus campbelli	LC
Phodopus roborovskii	LC
Phodopus sungorus	LC
Phoniscus aerosa	DD
Phoniscus atrox	NT
Phoniscus jagorii	LC
Phoniscus papuensis	LC
Phylloderma stenops	LC
Phyllomys blainvillii	LC
Phyllomys brasiliensis	EN
Phyllomys dasythrix	LC
Phyllomys kerri	DD
Phyllomys lamarum	DD
Phyllomys lundi	EN
Phyllomys mantiqueirensis	CR
Phyllomys medius	LC
Phyllomys nigrispinus	LC
Phyllomys pattoni	LC
Phyllomys sulinus	DD
Phyllomys thomasi	EN
Phyllomys unicolor	CR
Phyllonycteris aphylla	CR
Phyllonycteris poeyi	LC
Phyllops falcatus	LC
Phyllostomus discolor	LC
Phyllostomus elongatus	LC
Phyllostomus hastatus	LC
Phyllostomus latifolius	LC
Phyllotis alisosiensis	DD
Phyllotis amicus	LC
Phyllotis andium	LC
Phyllotis anitae	DD
Phyllotis bonariensis	NT
Phyllotis caprinus	LC
Phyllotis darwini	LC
Phyllotis definitus	EN
Phyllotis gerbillus	LC
Phyllotis haggardi	LC
Phyllotis limatus	LC
Phyllotis magister	LC
Phyllotis osgoodi	DD
Phyllotis osilae	LC
Phyllotis wolffsohni	LC
Phyllotis xanthopygus	LC
Physeter macrocephalus	VU
Physeter macrocephalus	VU
Piliocolobus badius	EN
Piliocolobus bouvieri	CR
Piliocolobus epieni	CR
Piliocolobus gordonorum	EN
Piliocolobus kirkii	EN
Piliocolobus oustaleti	LC
Piliocolobus pennantii	EN
Piliocolobus preussi	CR
Piliocolobus rufomitratus	EN
Piliocolobus temminckii	EN
Piliocolobus tephrosceles	EN
Piliocolobus tholloni	NT
Piliocolobus waldroni	CR
Pipistrellus abramus	LC
Pipistrellus adamsi	LC
Pipistrellus aero	DD
Pipistrellus alaschanicus	LC
Pipistrellus anchietae	LC
Pipistrellus angulatus	LC
Pipistrellus arabicus	DD
Pipistrellus ariel	DD
Pipistrellus cadornae	LC
Pipistrellus ceylonicus	LC
Pipistrellus collinus	LC
Pipistrellus coromandra	LC
Pipistrellus crassulus	LC
Pipistrellus eisentrauti	DD
Pipistrellus endoi	EN
Pipistrellus grandidieri	DD
Pipistrellus hanaki	DD
Pipistrellus hesperidus	LC
Pipistrellus imbricatus	LC
Pipistrellus inexspectatus	DD
Pipistrellus javanicus	LC
Pipistrellus kuhlii	LC
Pipistrellus maderensis	VU
Pipistrellus minahassae	DD
Pipistrellus musciculus	DD
Pipistrellus nanulus	LC
Pipistrellus nathusii	LC
Pipistrellus papuanus	LC
Pipistrellus paterculus	LC
Pipistrellus permixtus	DD
Pipistrellus pipistrellus	LC
Pipistrellus pulveratus	LC
Pipistrellus pygmaeus	LC
Pipistrellus raceyi	DD
Pipistrellus rueppellii	LC
Pipistrellus rusticus	LC
Pipistrellus stenopterus	LC
Pipistrellus sturdeei	DD
Pipistrellus tenuis	LC
Pipistrellus wattsi	LC
Pipistrellus westralis	LC
Pithecheir melanurus	VU
Pithecheir parvus	DD
Pithecheirops otion	DD
Pithecia aequatorialis	LC
Pithecia albicans	LC
Pithecia cazuzai	DD
Pithecia chrysocephala	LC
Pithecia hirsuta	DD
Pithecia inusta	LC
Pithecia isabela	DD
Pithecia milleri	DD
Pithecia monachus	LC
Pithecia napensis	LC
Pithecia pissinattii	DD
Pithecia pithecia	LC
Pithecia vanzolinii	DD
Plagiodontia aedium	EN
Planigale gilesi	LC
Planigale ingrami	LC
Planigale maculata	LC
Planigale novaeguineae	LC
Planigale tenuirostris	LC
Platacanthomys lasiurus	VU
Platalina genovensium	NT
Platanista gangetica	EN
Platymops setiger	LC
Platyrrhinus albericoi	LC
Platyrrhinus angustirostris	LC
Platyrrhinus aquilus	DD
Platyrrhinus aurarius	LC
Platyrrhinus brachycephalus	LC
Platyrrhinus chocoensis	VU
Platyrrhinus dorsalis	LC
Platyrrhinus fusciventris	LC
Platyrrhinus helleri	LC
Platyrrhinus incarum	LC
Platyrrhinus infuscus	LC
Platyrrhinus ismaeli	NT
Platyrrhinus lineatus	LC
Platyrrhinus masu	LC
Platyrrhinus matapalensis	NT
Platyrrhinus nigellus	LC
Platyrrhinus nitelinea	DD
Platyrrhinus recifinus	LC
Platyrrhinus umbratus	DD
Platyrrhinus vittatus	LC
Plecotus auritus	LC
Plecotus austriacus	LC
Plecotus balensis	DD
Plecotus christii	DD
Plecotus kolombatovici	LC
Plecotus macrobullaris	LC
Plecotus ognevi	LC
Plecotus sacrimontis	LC
Plecotus sardus	VU
Plecotus taivanus	NT
Plecotus teneriffae	VU
Plecturocebus aureipalatii	LC
Plecturocebus baptista	LC
Plecturocebus bernhardi	LC
Plecturocebus brunneus	LC
Plecturocebus caligatus	LC
Plecturocebus caquetensis	CR
Plecturocebus cinerascens	LC
Plecturocebus cupreus	LC
Plecturocebus discolor	LC
Plecturocebus donacophilus	LC
Plecturocebus dubius	LC
Plecturocebus hoffmannsi	LC
Plecturocebus modestus	EN
Plecturocebus moloch	LC
Plecturocebus oenanthe	CR
Plecturocebus olallae	EN
Plecturocebus ornatus	VU
Plecturocebus pallescens	LC
Plecturocebus stephennashi	DD
Plecturocebus vieirai	DD
Plerotes anchietae	DD
Podogymnura aureospinula	EN
Podogymnura truei	LC
Podomys floridanus	NT
Podoxymys roraimae	VU
Poecilogale albinucha	LC
Poelagus marjorita	LC
Pogonomelomys brassi	LC
Pogonomelomys bruijnii	LC
Pogonomelomys mayeri	LC
Pogonomys championi	DD
Pogonomys fergussoniensis	EN
Pogonomys loriae	LC
Pogonomys macrourus	LC
Pogonomys sylvestris	LC
Poiana leightoni	VU
Poiana richardsonii	LC
Poliocitellus franklinii	LC
Pongo abelii	CR
Pongo pygmaeus	CR
Pongo tapanuliensis	CR
Pontoporia blainvillei	VU
Pontoporia blainvillei	VU
Porcula salvania	CR
Potamochoerus larvatus	LC
Potamochoerus porcus	LC
Potamogale velox	LC
Potorous gilbertii	CR
Potorous longipes	VU
Potorous tridactylus	NT
Potos flavus	LC
Praomys coetzeei	DD
Praomys daltoni	LC
Praomys degraaffi	VU
Praomys delectorum	LC
Praomys derooi	LC
Praomys hartwigi	VU
Praomys jacksoni	LC
Praomys lukolelae	LC
Praomys minor	LC
Praomys misonnei	LC
Praomys morio	EN
Praomys mutoni	NT
Praomys obscurus	EN
Praomys petteri	LC
Praomys rostratus	LC
Praomys tullbergi	LC
Praomys verschureni	DD
Presbytis chrysomelas	CR
Presbytis comata	EN
Presbytis femoralis	NT
Presbytis frontata	VU
Presbytis hosei	VU
Presbytis melalophos	EN
Presbytis natunae	VU
Presbytis potenziani	EN
Presbytis rubicunda	LC
Presbytis siamensis	NT
Presbytis thomasi	VU
Priodontes maximus	VU
Prionailurus bengalensis	LC
Prionailurus planiceps	EN
Prionailurus rubiginosus	NT
Prionailurus viverrinus	VU
Prionodon linsang	LC
Prionodon pardicolor	LC
Prionomys batesi	DD
Procapra gutturosa	LC
Procapra picticaudata	NT
Procapra przewalskii	EN
Procavia capensis	LC
Procolobus verus	VU
Procyon cancrivorus	LC
Procyon lotor	LC
Procyon pygmaeus	CR
Proechimys brevicauda	LC
Proechimys canicollis	LC
Proechimys chrysaeolus	DD
Proechimys cuvieri	LC
Proechimys decumanus	NT
Proechimys echinothrix	LC
Proechimys gardneri	DD
Proechimys goeldii	LC
Proechimys guairae	LC
Proechimys guyannensis	LC
Proechimys hoplomyoides	DD
Proechimys kulinae	DD
Proechimys longicaudatus	LC
Proechimys mincae	DD
Proechimys oconnelli	DD
Proechimys pattoni	LC
Proechimys quadruplicatus	LC
Proechimys roberti	LC
Proechimys semispinosus	LC
Proechimys simonsi	LC
Proechimys steerei	LC
Proechimys trinitatis	DD
Proedromys bedfordi	VU
Proedromys liangshanensis	DD
Prolemur simus	CR
Prometheomys schaposchnikowi	LC
Promops centralis	LC
Promops davisoni	DD
Promops nasutus	LC
Pronolagus crassicaudatus	LC
Pronolagus randensis	LC
Pronolagus rupestris	LC
Pronolagus saundersiae	LC
Propithecus candidus	CR
Propithecus coquereli	EN
Propithecus coronatus	EN
Propithecus deckenii	EN
Propithecus diadema	CR
Propithecus edwardsi	EN
Propithecus perrieri	CR
Propithecus tattersalli	CR
Propithecus verreauxi	EN
Prosciurillus abstrusus	DD
Prosciurillus leucomus	DD
Prosciurillus murinus	LC
Prosciurillus rosenbergii	LC
Prosciurillus weberi	EN
Proteles cristata	LC
Protochromys fellowsi	LC
Protoxerus aubinnii	NT
Protoxerus stangeri	LC
Psammomys obesus	LC
Psammomys vexillaris	DD
Pseudantechinus bilarni	LC
Pseudantechinus macdonnellensis	LC
Pseudantechinus mimulus	NT
Pseudantechinus ningbing	LC
Pseudantechinus roryi	LC
Pseudantechinus woolleyae	LC
Pseudoberylmys muongbangensis	DD
Pseudocheirus occidentalis	CR
Pseudocheirus peregrinus	LC
Pseudochirops albertisii	NT
Pseudochirops archeri	NT
Pseudochirops corinnae	NT
Pseudochirops coronatus	VU
Pseudochirops cupreus	LC
Pseudochirulus canescens	LC
Pseudochirulus caroli	LC
Pseudochirulus cinereus	NT
Pseudochirulus forbesi	LC
Pseudochirulus herbertensis	LC
Pseudochirulus larvatus	LC
Pseudochirulus mayeri	LC
Pseudochirulus schlegeli	VU
Pseudohydromys berniceae	LC
Pseudohydromys carlae	DD
Pseudohydromys eleanorae	DD
Pseudohydromys ellermani	LC
Pseudohydromys fuscus	LC
Pseudohydromys germani	DD
Pseudohydromys murinus	LC
Pseudohydromys musseri	DD
Pseudohydromys occidentalis	DD
Pseudohydromys patriciae	DD
Pseudohydromys pumehanae	DD
Pseudohydromys sandrae	DD
Pseudois nayaur	LC
Pseudomys albocinereus	LC
Pseudomys apodemoides	LC
Pseudomys australis	VU
Pseudomys bolami	LC
Pseudomys calabyi	VU
Pseudomys chapmani	LC
Pseudomys delicatulus	LC
Pseudomys desertor	LC
Pseudomys fieldi	VU
Pseudomys fumeus	VU
Pseudomys gracilicaudatus	LC
Pseudomys hermannsburgensis	LC
Pseudomys higginsi	LC
Pseudomys johnsoni	LC
Pseudomys nanus	LC
Pseudomys novaehollandiae	VU
Pseudomys occidentalis	NT
Pseudomys oralis	VU
Pseudomys patrius	LC
Pseudomys pilligaensis	DD
Pseudomys shortridgei	NT
Pseudorca crassidens	NT
Pseudoryx nghetinhensis	CR
Pseudoryzomys simplex	LC
Ptenochirus jagori	LC
Ptenochirus minor	LC
Pteralopex anceps	EN
Pteralopex atrata	EN
Pteralopex flanneryi	CR
Pteralopex pulchra	CR
Pteralopex taki	VU
Pteromys momonga	LC
Pteromys volans	LC
Pteromyscus pulverulentus	EN
Pteronotus davyi	LC
Pteronotus gymnonotus	LC
Pteronotus macleayii	LC
Pteronotus mesoamericanus	LC
Pteronotus paraguanensis	EN
Pteronotus parnellii	LC
Pteronotus personatus	LC
Pteronotus quadridens	LC
Pteronotus rubiginosus	LC
Pteronura brasiliensis	EN
Pteropus admiralitatum	LC
Pteropus aldabrensis	VU
Pteropus alecto	LC
Pteropus anetianus	VU
Pteropus aruensis	CR
Pteropus caniceps	VU
Pteropus capistratus	NT
Pteropus chrysoproctus	VU
Pteropus cognatus	VU
Pteropus conspicillatus	LC
Pteropus dasymallus	VU
Pteropus faunulus	VU
Pteropus fundatus	EN
Pteropus giganteus	LC
Pteropus gilliardorum	DD
Pteropus griseus	DD
Pteropus howensis	DD
Pteropus hypomelanus	LC
Pteropus intermedius	DD
Pteropus keyensis	DD
Pteropus leucopterus	LC
Pteropus livingstonii	CR
Pteropus lombocensis	DD
Pteropus loochoensis	DD
Pteropus lylei	VU
Pteropus macrotis	LC
Pteropus mahaganus	LC
Pteropus mariannus	EN
Pteropus melanopogon	EN
Pteropus melanotus	VU
Pteropus molossinus	VU
Pteropus neohibernicus	LC
Pteropus niger	EN
Pteropus nitendiensis	EN
Pteropus ocularis	VU
Pteropus ornatus	VU
Pteropus personatus	LC
Pteropus pohlei	VU
Pteropus poliocephalus	VU
Pteropus pselaphon	EN
Pteropus pumilus	NT
Pteropus rayneri	NT
Pteropus rennelli	EN
Pteropus rodricensis	EN
Pteropus rufus	VU
Pteropus samoensis	NT
Pteropus scapulatus	LC
Pteropus seychellensis	LC
Pteropus speciosus	DD
Pteropus temminckii	VU
Pteropus tonganus	LC
Pteropus tuberculatus	CR
Pteropus ualanus	VU
Pteropus vampyrus	NT
Pteropus vetulus	VU
Pteropus voeltzkowi	VU
Pteropus woodfordi	LC
Ptilocercus lowii	LC
Pudu mephistophiles	DD
Pudu puda	NT
Puma concolor	LC
Punomys kofordi	VU
Punomys lemminus	VU
Pusa caspica	EN
Pusa hispida	LC
Pusa sibirica	LC
Pygathrix cinerea	CR
Pygathrix nemaeus	EN
Pygathrix nigripes	EN
Pygeretmus platyurus	LC
Pygeretmus pumilio	LC
Pygeretmus zhitkovi	NT
Pygoderma bilabiatum	LC
Rangifer tarandus	VU
Raphicerus campestris	LC
Raphicerus melanotis	LC
Raphicerus sharpei	LC
Rattus adustus	DD
Rattus andamanensis	LC
Rattus annandalei	LC
Rattus arfakiensis	DD
Rattus argentiventer	LC
Rattus arrogans	LC
Rattus baluensis	LC
Rattus blangorum	DD
Rattus bontanus	DD
Rattus burrus	EN
Rattus colletti	LC
Rattus detentus	DD
Rattus elaphinus	NT
Rattus enganus	DD
Rattus everetti	LC
Rattus exulans	LC
Rattus feliceus	NT
Rattus fuscipes	LC
Rattus giluwensis	LC
Rattus hainaldi	EN
Rattus hoffmanni	LC
Rattus hoogerwerfi	VU
Rattus jobiensis	LC
Rattus koopmani	DD
Rattus korinchi	DD
Rattus leucopus	LC
Rattus losea	LC
Rattus lugens	VU
Rattus lutreolus	LC
Rattus marmosurus	LC
Rattus mindorensis	LC
Rattus mollicomulus	LC
Rattus montanus	EN
Rattus mordax	LC
Rattus morotaiensis	LC
Rattus nikenii	VU
Rattus niobe	LC
Rattus nitidus	LC
Rattus norvegicus	LC
Rattus novaeguineae	LC
Rattus omichlodes	DD
Rattus osgoodi	LC
Rattus palmarum	VU
Rattus pelurus	DD
Rattus pococki	LC
Rattus praetor	LC
Rattus pyctoris	LC
Rattus ranjiniae	EN
Rattus rattus	LC
Rattus richardsoni	VU
Rattus salocco	DD
Rattus satarae	VU
Rattus simalurensis	EN
Rattus sordidus	LC
Rattus steini	LC
Rattus stoicus	VU
Rattus tanezumi	LC
Rattus tawitawiensis	DD
Rattus timorensis	DD
Rattus tiomanicus	LC
Rattus tunneyi	LC
Rattus vandeuseni	EN
Rattus verecundus	LC
Rattus villosissimus	LC
Rattus xanthurus	NT
Ratufa affinis	NT
Ratufa bicolor	NT
Ratufa indica	LC
Ratufa macroura	NT
Redunca arundinum	LC
Redunca fulvorufula	EN
Redunca redunca	LC
Reithrodon auritus	LC
Reithrodon typicus	LC
Reithrodontomys bakeri	EN
Reithrodontomys brevirostris	LC
Reithrodontomys burti	DD
Reithrodontomys chrysopsis	LC
Reithrodontomys creper	LC
Reithrodontomys darienensis	LC
Reithrodontomys fulvescens	LC
Reithrodontomys gracilis	LC
Reithrodontomys hirsutus	VU
Reithrodontomys humulis	LC
Reithrodontomys megalotis	LC
Reithrodontomys mexicanus	LC
Reithrodontomys microdon	LC
Reithrodontomys montanus	LC
Reithrodontomys musseri	DD
Reithrodontomys paradoxus	DD
Reithrodontomys raviventris	EN
Reithrodontomys rodriguezi	LC
Reithrodontomys spectabilis	CR
Reithrodontomys sumichrasti	LC
Reithrodontomys tenuirostris	VU
Reithrodontomys zacatecae	LC
Rhabdomys bechuanae	LC
Rhabdomys dilectus	LC
Rhabdomys intermedius	LC
Rhabdomys pumilio	LC
Rhagomys longilingua	LC
Rhagomys rufescens	VU
Rheithrosciurus macrotis	VU
Rheomys mexicanus	EN
Rheomys raptor	LC
Rheomys thomasi	NT
Rheomys underwoodi	LC
Rhinoceros sondaicus	CR
Rhinoceros unicornis	VU
Rhinolophus acuminatus	LC
Rhinolophus adami	DD
Rhinolophus affinis	LC
Rhinolophus alcyone	LC
Rhinolophus arcuatus	LC
Rhinolophus beddomei	LC
Rhinolophus belligerator	EN
Rhinolophus blasii	LC
Rhinolophus bocharicus	LC
Rhinolophus borneensis	LC
Rhinolophus canuti	VU
Rhinolophus capensis	LC
Rhinolophus celebensis	LC
Rhinolophus clivosus	LC
Rhinolophus coelophyllus	LC
Rhinolophus cognatus	EN
Rhinolophus cohenae	VU
Rhinolophus convexus	DD
Rhinolophus creaghi	LC
Rhinolophus damarensis	LC
Rhinolophus darlingi	LC
Rhinolophus deckenii	NT
Rhinolophus denti	LC
Rhinolophus eloquens	LC
Rhinolophus euryale	NT
Rhinolophus euryotis	LC
Rhinolophus ferrumequinum	LC
Rhinolophus formosae	NT
Rhinolophus fumigatus	LC
Rhinolophus guineensis	VU
Rhinolophus hildebrandtii	LC
Rhinolophus hilli	CR
Rhinolophus hillorum	NT
Rhinolophus hipposideros	LC
Rhinolophus indorouxii	DD
Rhinolophus inops	LC
Rhinolophus keyensis	DD
Rhinolophus landeri	LC
Rhinolophus lepidus	LC
Rhinolophus luctus	LC
Rhinolophus mabuensis	EN
Rhinolophus maclaudi	EN
Rhinolophus macrotis	LC
Rhinolophus madurensis	VU
Rhinolophus maendeleo	DD
Rhinolophus malayanus	LC
Rhinolophus marshalli	LC
Rhinolophus mcintyrei	DD
Rhinolophus megaphyllus	LC
Rhinolophus mehelyi	VU
Rhinolophus microglobosus	LC
Rhinolophus mitratus	DD
Rhinolophus montanus	EN
Rhinolophus mossambicus	LC
Rhinolophus nereis	DD
Rhinolophus osgoodi	DD
Rhinolophus paradoxolophus	LC
Rhinolophus pearsonii	LC
Rhinolophus philippinensis	LC
Rhinolophus proconsulis	EN
Rhinolophus pusillus	LC
Rhinolophus rex	LC
Rhinolophus robinsoni	NT
Rhinolophus rouxii	LC
Rhinolophus rufus	NT
Rhinolophus ruwenzorii	VU
Rhinolophus sakejiensis	DD
Rhinolophus sedulus	NT
Rhinolophus shameli	LC
Rhinolophus shortridgei	LC
Rhinolophus siamensis	LC
Rhinolophus silvestris	DD
Rhinolophus simulator	LC
Rhinolophus sinicus	LC
Rhinolophus smithersi	NT
Rhinolophus stheno	LC
Rhinolophus subbadius	LC
Rhinolophus subrufus	DD
Rhinolophus swinnyi	LC
Rhinolophus tatar	LC
Rhinolophus thomasi	LC
Rhinolophus trifoliatus	LC
Rhinolophus virgo	LC
Rhinolophus xinanzhongguoensis	NT
Rhinolophus yunanensis	LC
Rhinolophus ziama	EN
Rhinonicteris aurantia	LC
Rhinophylla alethina	NT
Rhinophylla fischerae	LC
Rhinophylla pumilio	LC
Rhinopithecus avunculus	CR
Rhinopithecus bieti	EN
Rhinopithecus brelichi	EN
Rhinopithecus roxellana	EN
Rhinopithecus strykeri	CR
Rhinopoma cystops	LC
Rhinopoma hadramauticum	EN
Rhinopoma hardwickii	LC
Rhinopoma macinnesi	DD
Rhinopoma microphyllum	LC
Rhinopoma muscatellum	LC
Rhinosciurus laticaudatus	NT
Rhipidomys albujai	DD
Rhipidomys austrinus	LC
Rhipidomys cariri	DD
Rhipidomys caucensis	DD
Rhipidomys couesi	LC
Rhipidomys emiliae	LC
Rhipidomys fulviventer	LC
Rhipidomys gardneri	LC
Rhipidomys ipukensis	DD
Rhipidomys itoan	LC
Rhipidomys latimanus	LC
Rhipidomys leucodactylus	LC
Rhipidomys macconnelli	LC
Rhipidomys macrurus	LC
Rhipidomys mastacalis	LC
Rhipidomys modicus	LC
Rhipidomys nitela	LC
Rhipidomys ochrogaster	DD
Rhipidomys tribei	DD
Rhipidomys venezuelae	LC
Rhipidomys venustus	LC
Rhipidomys wetzeli	LC
Rhizomys pruinosus	LC
Rhizomys sinensis	LC
Rhizomys sumatrensis	LC
Rhogeessa aeneus	LC
Rhogeessa bickhami	LC
Rhogeessa genowaysi	EN
Rhogeessa hussoni	DD
Rhogeessa io	LC
Rhogeessa menchuae	DD
Rhogeessa minutilla	VU
Rhogeessa mira	VU
Rhogeessa parvula	LC
Rhogeessa tumida	LC
Rhogeessa velilla	DD
Rhombomys opimus	LC
Rhynchocyon chrysopygus	EN
Rhynchocyon cirnei	LC
Rhynchocyon petersi	LC
Rhynchocyon udzungwensis	VU
Rhynchogale melleri	LC
Rhyncholestes raphanurus	NT
Rhynchomeles prattorum	EN
Rhynchomys banahao	LC
Rhynchomys isarogensis	VU
Rhynchomys soricoides	NT
Rhynchomys tapulao	DD
Rhynchonycteris naso	LC
Romerolagus diazi	EN
Rousettus aegyptiacus	LC
Rousettus amplexicaudatus	LC
Rousettus bidens	VU
Rousettus celebensis	LC
Rousettus lanosus	LC
Rousettus leschenaultii	LC
Rousettus linduensis	DD
Rousettus madagascariensis	NT
Rousettus obliviosus	VU
Rousettus spinalatus	VU
Rubrisciurus rubriventer	VU
Rucervus duvaucelii	VU
Rucervus eldii	EN
Rungwecebus kipunji	CR
Rupicapra pyrenaica	LC
Rupicapra rupicapra	LC
Rusa alfredi	EN
Rusa marianna	VU
Rusa timorensis	VU
Rusa unicolor	VU
Ruwenzorisorex suncoides	VU
Saccolaimus flaviventris	LC
Saccolaimus mixtus	NT
Saccolaimus peli	LC
Saccolaimus saccolaimus	LC
Saccopteryx antioquensis	EN
Saccopteryx bilineata	LC
Saccopteryx canescens	LC
Saccopteryx gymnura	DD
Saccopteryx leptura	LC
Saccostomus campestris	LC
Saccostomus mearnsi	LC
Saguinus bicolor	EN
Saguinus fuscicollis	LC
Saguinus geoffroyi	LC
Saguinus imperator	LC
Saguinus inustus	LC
Saguinus labiatus	LC
Saguinus leucopus	EN
Saguinus martinsi	LC
Saguinus melanoleucus	LC
Saguinus midas	LC
Saguinus mystax	LC
Saguinus niger	VU
Saguinus nigricollis	LC
Saguinus oedipus	CR
Saguinus tripartitus	NT
Saiga tatarica	CR
Saimiri boliviensis	LC
Saimiri oerstedii	VU
Saimiri sciureus	LC
Saimiri ustus	NT
Saimiri vanzolinii	VU
Salanoia concolor	VU
Salinomys delicatus	DD
Salpingotulus michaelis	DD
Salpingotus crassicauda	LC
Salpingotus heptneri	DD
Salpingotus kozlovi	LC
Salpingotus pallidus	DD
Santamartamys rufodorsalis	CR
Sapajus apella	LC
Sapajus cay	LC
Sapajus flavius	CR
Sapajus libidinosus	LC
Sapajus macrocephalus	LC
Sapajus nigritus	NT
Sapajus robustus	EN
Sapajus xanthosternos	CR
Sarcophilus harrisii	EN
Sauromys petrophilus	LC
Saxatilomys paulinae	DD
Scalopus aquaticus	LC
Scapanulus oweni	LC
Scapanus latimanus	LC
Scapanus orarius	LC
Scapanus townsendii	LC
Scapteromys aquaticus	LC
Scapteromys tumidus	LC
Scaptochirus moschatus	LC
Scaptonyx fusicaudus	LC
Sciurillus pusillus	LC
Sciurocheirus alleni	LC
Sciurocheirus gabonensis	LC
Sciurotamias davidianus	LC
Sciurotamias forresti	LC
Sciurus aberti	LC
Sciurus aestuans	LC
Sciurus alleni	LC
Sciurus anomalus	LC
Sciurus arizonensis	DD
Sciurus aureogaster	LC
Sciurus carolinensis	LC
Sciurus colliaei	LC
Sciurus deppei	LC
Sciurus flammifer	DD
Sciurus gilvigularis	DD
Sciurus granatensis	LC
Sciurus griseus	LC
Sciurus ignitus	LC
Sciurus igniventris	LC
Sciurus lis	LC
Sciurus nayaritensis	LC
Sciurus niger	LC
Sciurus oculatus	LC
Sciurus pucheranii	DD
Sciurus pyrrhinus	DD
Sciurus richmondi	NT
Sciurus sanborni	DD
Sciurus spadiceus	LC
Sciurus stramineus	LC
Sciurus variegatoides	LC
Sciurus vulgaris	LC
Sciurus yucatanensis	LC
Scleronycteris ega	DD
Scolomys melanops	LC
Scolomys ucayalensis	LC
Scoteanax rueppellii	LC
Scotinomys teguina	LC
Scotinomys xerampelinus	LC
Scotoecus albofuscus	DD
Scotoecus hirundo	LC
Scotoecus pallidus	LC
Scotomanes ornatus	LC
Scotonycteris ophiodon	NT
Scotonycteris zenkeri	LC
Scotophilus andrewreborii	LC
Scotophilus borbonicus	DD
Scotophilus celebensis	DD
Scotophilus collinus	LC
Scotophilus dinganii	LC
Scotophilus ejetai	LC
Scotophilus heathii	LC
Scotophilus kuhlii	LC
Scotophilus leucogaster	LC
Scotophilus livingstonii	LC
Scotophilus marovaza	LC
Scotophilus nigrita	LC
Scotophilus nucella	DD
Scotophilus nux	LC
Scotophilus robustus	LC
Scotophilus tandrefana	DD
Scotophilus trujilloi	LC
Scotophilus viridis	LC
Scotorepens balstoni	LC
Scotorepens greyii	LC
Scotorepens orion	LC
Scotorepens sanborni	LC
Scotozous dormeri	LC
Scutisorex somereni	LC
Scutisorex thori	DD
Sekeetamys calurus	LC
Selevinia betpakdalaensis	DD
Semnopithecus ajax	EN
Semnopithecus dussumieri	LC
Semnopithecus entellus	LC
Semnopithecus hector	NT
Semnopithecus hypoleucos	VU
Semnopithecus priam	NT
Semnopithecus schistaceus	LC
Setifer setosus	LC
Setonix brachyurus	VU
Sicista armenica	EN
Sicista betulina	LC
Sicista caucasica	VU
Sicista caudata	DD
Sicista concolor	LC
Sicista kazbegica	EN
Sicista kluchorica	LC
Sicista loriger	VU
Sicista napaea	LC
Sicista pseudonapaea	DD
Sicista severtzovi	LC
Sicista strandi	LC
Sicista subtilis	LC
Sicista tianshanica	LC
Sicista trizona	EN
Sigmodon alleni	VU
Sigmodon alstoni	LC
Sigmodon arizonae	LC
Sigmodon fulviventer	LC
Sigmodon hirsutus	LC
Sigmodon hispidus	LC
Sigmodon inopinatus	VU
Sigmodon leucotis	LC
Sigmodon mascotensis	LC
Sigmodon ochrognathus	LC
Sigmodon peruanus	LC
Sigmodon toltecus	LC
Sigmodontomys alfari	LC
Simias concolor	CR
Sminthopsis archeri	DD
Sminthopsis bindi	NT
Sminthopsis butleri	VU
Sminthopsis crassicaudata	LC
Sminthopsis dolichura	LC
Sminthopsis douglasi	NT
Sminthopsis fuliginosus	DD
Sminthopsis gilberti	LC
Sminthopsis granulipes	LC
Sminthopsis griseoventer	LC
Sminthopsis hirtipes	LC
Sminthopsis leucopus	LC
Sminthopsis longicaudata	LC
Sminthopsis macroura	LC
Sminthopsis murina	LC
Sminthopsis ooldea	LC
Sminthopsis psammophila	VU
Sminthopsis virginiae	LC
Sminthopsis youngsoni	LC
Smutsia gigantea	VU
Smutsia temminckii	VU
Solenodon paradoxus	EN
Solisorex pearsoni	EN
Solomys ponceleti	CR
Solomys salamonis	DD
Solomys salebrosus	EN
Solomys sapientis	EN
Sommeromys macrorhinos	DD
Sooretamys angouya	LC
Sorex alaskanus	DD
Sorex alpinus	NT
Sorex antinorii	LC
Sorex araneus	LC
Sorex arcticus	LC
Sorex arizonae	LC
Sorex asper	LC
Sorex bairdi	LC
Sorex bedfordiae	LC
Sorex bendirii	LC
Sorex buchariensis	DD
Sorex caecutiens	LC
Sorex camtschatica	LC
Sorex cansulus	DD
Sorex cinereus	LC
Sorex coronatus	LC
Sorex cylindricauda	LC
Sorex daphaenodon	LC
Sorex dispar	LC
Sorex emarginatus	LC
Sorex excelsus	LC
Sorex fumeus	LC
Sorex gracillimus	LC
Sorex granarius	LC
Sorex haydeni	LC
Sorex hosonoi	LC
Sorex hoyi	LC
Sorex isodon	LC
Sorex ixtlanensis	DD
Sorex jacksoni	LC
Sorex kozlovi	DD
Sorex leucogaster	DD
Sorex longirostris	LC
Sorex lyelli	LC
Sorex macrodon	VU
Sorex maritimensis	LC
Sorex mediopua	LC
Sorex merriami	LC
Sorex milleri	VU
Sorex minutissimus	LC
Sorex minutus	LC
Sorex mirabilis	DD
Sorex monticolus	LC
Sorex nanus	LC
Sorex neomexicanus	DD
Sorex oreopolus	LC
Sorex orizabae	LC
Sorex ornatus	LC
Sorex pacificus	LC
Sorex palustris	LC
Sorex planiceps	LC
Sorex portenkoi	DD
Sorex preblei	LC
Sorex pribilofensis	EN
Sorex raddei	LC
Sorex roboratus	LC
Sorex rohweri	LC
Sorex samniticus	LC
Sorex satunini	LC
Sorex saussurei	LC
Sorex sclateri	CR
Sorex shinto	LC
Sorex sinalis	DD
Sorex sonomae	LC
Sorex stizodon	CR
Sorex tenellus	LC
Sorex thibetanus	DD
Sorex trowbridgii	LC
Sorex tundrensis	LC
Sorex ugyunak	LC
Sorex unguiculatus	LC
Sorex vagrans	LC
Sorex ventralis	LC
Sorex veraecrucis	LC
Sorex veraepacis	LC
Sorex volnuchini	LC
Sorex yukonicus	LC
Soricomys kalinga	LC
Soricomys leonardocoi	DD
Soricomys montanus	LC
Soricomys musseri	LC
Soriculus nigrescens	LC
Sotalia fluviatilis	DD
Sotalia guianensis	NT
Sousa chinensis	VU
Sousa plumbea	EN
Sousa sahulensis	VU
Sousa teuszii	CR
Spalacopus cyanus	LC
Spalax arenarius	EN
Spalax giganteus	LC
Spalax graecus	NT
Spalax microphthalmus	LC
Spalax uralensis	NT
Spalax zemni	VU
Speothos venaticus	NT
Spermophilopsis leptodactylus	LC
Spermophilus alashanicus	LC
Spermophilus brevicauda	LC
Spermophilus citellus	VU
Spermophilus dauricus	LC
Spermophilus erythrogenys	LC
Spermophilus fulvus	LC
Spermophilus major	LC
Spermophilus musicus	NT
Spermophilus pallidicauda	LC
Spermophilus pygmaeus	LC
Spermophilus ralli	LC
Spermophilus relictus	LC
Spermophilus suslicus	NT
Spermophilus taurensis	LC
Spermophilus xanthoprymnus	NT
Sphaerias blanfordi	LC
Sphaeronycteris toxophyllum	LC
Spilocuscus kraemeri	NT
Spilocuscus maculatus	LC
Spilocuscus papuensis	VU
Spilocuscus rufoniger	CR
Spilocuscus wilsoni	CR
Spilogale angustifrons	LC
Spilogale gracilis	LC
Spilogale putorius	VU
Spilogale pygmaea	VU
Srilankamys ohiensis	VU
Steatomys bocagei	LC
Steatomys caurinus	LC
Steatomys cuppedius	LC
Steatomys jacksoni	DD
Steatomys krebsii	LC
Steatomys opimus	LC
Steatomys parvus	LC
Steatomys pratensis	LC
Stenella attenuata	LC
Stenella clymene	LC
Stenella coeruleoalba	LC
Stenella coeruleoalba	LC
Stenella frontalis	LC
Stenella longirostris	LC
Steno bredanensis	LC
Stenocephalemys albipes	LC
Stenocephalemys albocaudata	LC
Stenocephalemys griseicauda	LC
Stenocephalemys ruppi	DD
Stenoderma rufum	NT
Stochomys longicaudatus	LC
Strigocuscus celebensis	VU
Strigocuscus pelengensis	LC
Sturnira aratathomasi	LC
Sturnira bakeri	LC
Sturnira bidens	LC
Sturnira bogotensis	LC
Sturnira burtonlimi	DD
Sturnira erythromos	LC
Sturnira hondurensis	LC
Sturnira koopmanhilli	DD
Sturnira lilium	LC
Sturnira ludovici	LC
Sturnira luisi	LC
Sturnira magna	LC
Sturnira mistratensis	DD
Sturnira mordax	LC
Sturnira nana	EN
Sturnira oporaphilum	LC
Sturnira parvidens	LC
Sturnira perla	DD
Sturnira sorianoi	DD
Sturnira tildae	LC
Styloctenium mindorensis	DD
Styloctenium wallacei	NT
Stylodipus andrewsi	LC
Stylodipus sungorus	LC
Stylodipus telum	LC
Submyotodon latirostris	LC
Suncus aequatorius	EN
Suncus ater	DD
Suncus dayi	EN
Suncus etruscus	LC
Suncus fellowesgordoni	EN
Suncus hosei	DD
Suncus hututsi	DD
Suncus infinitesimus	LC
Suncus lixus	LC
Suncus malayanus	LC
Suncus megalura	LC
Suncus mertensi	EN
Suncus montanus	VU
Suncus murinus	LC
Suncus remyi	LC
Suncus stoliczkanus	LC
Suncus varilla	LC
Suncus zeylanicus	EN
Sundamys infraluteus	LC
Sundamys maxi	VU
Sundamys muelleri	LC
Sundasciurus brookei	LC
Sundasciurus davensis	DD
Sundasciurus fraterculus	VU
Sundasciurus hippurus	NT
Sundasciurus hoogstraali	LC
Sundasciurus jentinki	LC
Sundasciurus juvencus	LC
Sundasciurus lowii	LC
Sundasciurus mindanensis	LC
Sundasciurus moellendorffi	NT
Sundasciurus philippinensis	LC
Sundasciurus rabori	DD
Sundasciurus samarensis	LC
Sundasciurus steerii	LC
Sundasciurus tenuis	LC
Surdisorex norae	LC
Surdisorex polulus	DD
Surdisorex schlitteri	DD
Suricata suricatta	LC
Sus ahoenobarbus	NT
Sus barbatus	VU
Sus cebifrons	CR
Sus celebensis	NT
Sus oliveri	VU
Sus philippensis	VU
Sus scrofa	LC
Sus verrucosus	EN
Syconycteris australis	LC
Syconycteris carolinae	VU
Syconycteris hobbit	LC
Sylvicapra grimmia	LC
Sylvilagus andinus	DD
Sylvilagus aquaticus	LC
Sylvilagus audubonii	LC
Sylvilagus bachmani	LC
Sylvilagus brasiliensis	EN
Sylvilagus cognatus	EN
Sylvilagus cunicularius	LC
Sylvilagus dicei	VU
Sylvilagus floridanus	LC
Sylvilagus gabbi	LC
Sylvilagus graysoni	EN
Sylvilagus insonus	DD
Sylvilagus mansuetus	CR
Sylvilagus nuttallii	LC
Sylvilagus obscurus	NT
Sylvilagus palustris	LC
Sylvilagus robustus	EN
Sylvilagus transitionalis	VU
Sylvilagus varynaensis	DD
Sylvisorex akaibei	DD
Sylvisorex camerunensis	VU
Sylvisorex corbeti	DD
Sylvisorex granti	LC
Sylvisorex howelli	LC
Sylvisorex isabellae	EN
Sylvisorex johnstoni	LC
Sylvisorex konganensis	DD
Sylvisorex lunaris	NT
Sylvisorex morio	EN
Sylvisorex ollula	LC
Sylvisorex oriundus	DD
Sylvisorex pluvialis	DD
Sylvisorex silvanorum	DD
Sylvisorex vulcanorum	LC
Symphalangus syndactylus	EN
Synaptomys borealis	LC
Synaptomys cooperi	LC
Syncerus caffer	NT
Syntheosciurus brochus	DD
Tachyglossus aculeatus	LC
Tachyoryctes macrocephalus	EN
Tachyoryctes splendens	LC
Tadarida aegyptiaca	LC
Tadarida brasiliensis	LC
Tadarida fulminans	LC
Tadarida insignis	DD
Tadarida latouchei	DD
Tadarida lobata	LC
Tadarida teniotis	LC
Tadarida ventralis	DD
Taeromys arcuatus	LC
Taeromys callitrichus	DD
Taeromys celebensis	LC
Taeromys hamatus	DD
Taeromys microbullatus	DD
Taeromys punicans	DD
Taeromys taerae	VU
Talpa altaica	LC
Talpa caeca	LC
Talpa caucasica	LC
Talpa davidiana	DD
Talpa europaea	LC
Talpa levantis	LC
Talpa occidentalis	LC
Talpa romana	LC
Talpa stankovici	LC
Tamandua mexicana	LC
Tamandua tetradactyla	LC
Tamias striatus	LC
Tamiasciurus douglasii	LC
Tamiasciurus hudsonicus	LC
Tamiasciurus mearnsi	EN
Tamiops macclellandii	LC
Tamiops maritimus	LC
Tamiops rodolphii	LC
Tamiops swinhoei	LC
Tanyuromys aphrastus	DD
Tapecomys primus	LC
Taphozous achates	DD
Taphozous australis	NT
Taphozous georgianus	LC
Taphozous hamiltoni	DD
Taphozous hildegardeae	VU
Taphozous hilli	LC
Taphozous kapalgensis	LC
Taphozous longimanus	LC
Taphozous mauritianus	LC
Taphozous melanopogon	LC
Taphozous nudiventris	LC
Taphozous perforatus	LC
Taphozous theobaldi	LC
Taphozous troughtoni	LC
Tapirus bairdii	EN
Tapirus indicus	EN
Tapirus pinchaque	EN
Tapirus terrestris	VU
Tarsipes rostratus	LC
Tarsius bancanus	VU
Tarsius dentatus	VU
Tarsius lariang	DD
Tarsius pelengensis	EN
Tarsius pumilus	DD
Tarsius sangirensis	EN
Tarsius syrichta	NT
Tarsius tarsier	VU
Tarsius tumpara	CR
Tarsius wallacei	DD
Tarsomys apoensis	LC
Tarsomys echinatus	VU
Tasmacetus shepherdi	DD
Tateomys macrocercus	DD
Tateomys rhinogradoides	DD
Tatera indica	LC
Taterillus arenarius	LC
Taterillus congicus	LC
Taterillus emini	LC
Taterillus gracilis	LC
Taterillus lacustris	LC
Taterillus petteri	LC
Taterillus pygargus	LC
Taterillus tranieri	LC
Taxidea taxus	LC
Tayassu pecari	VU
Tenrec ecaudatus	LC
Tetracerus quadricornis	VU
Thallomys loringi	LC
Thallomys nigricauda	LC
Thallomys paedulcus	LC
Thallomys shortridgei	DD
Thalpomys cerradensis	LC
Thalpomys lasiotis	LC
Thamnomys kempi	VU
Thamnomys schoutedeni	DD
Thamnomys venustus	LC
Thaptomys nigrita	LC
Theropithecus gelada	LC
Thomasomys andersoni	DD
Thomasomys apeco	VU
Thomasomys aureus	LC
Thomasomys auricularis	DD
Thomasomys australis	DD
Thomasomys baeops	LC
Thomasomys bombycinus	VU
Thomasomys caudivarius	LC
Thomasomys cinereiventer	LC
Thomasomys cinereus	LC
Thomasomys cinnameus	LC
Thomasomys contradictus	DD
Thomasomys daphne	LC
Thomasomys dispar	DD
Thomasomys eleusis	VU
Thomasomys emeritus	DD
Thomasomys erro	LC
Thomasomys fumeus	DD
Thomasomys gracilis	NT
Thomasomys hudsoni	VU
Thomasomys hylophilus	VU
Thomasomys incanus	LC
Thomasomys ischyrus	LC
Thomasomys kalinowskii	LC
Thomasomys ladewi	LC
Thomasomys laniger	LC
Thomasomys macrotis	VU
Thomasomys monochromos	VU
Thomasomys nicefori	LC
Thomasomys niveipes	LC
Thomasomys notatus	LC
Thomasomys onkiro	VU
Thomasomys oreas	LC
Thomasomys paramorum	LC
Thomasomys popayanus	DD
Thomasomys praetor	NT
Thomasomys princeps	DD
Thomasomys pyrrhonotus	VU
Thomasomys rosalinda	EN
Thomasomys silvestris	LC
Thomasomys taczanowskii	LC
Thomasomys ucucha	VU
Thomasomys vestitus	LC
Thomasomys vulcani	LC
Thomomys bottae	LC
Thomomys bulbivorus	LC
Thomomys clusius	LC
Thomomys idahoensis	LC
Thomomys mazama	LC
Thomomys monticola	LC
Thomomys talpoides	LC
Thomomys townsendii	LC
Thomomys umbrinus	LC
Thoopterus nigrescens	LC
Thrichomys apereoides	LC
Thrichomys inermis	LC
Thrichomys laurentius	DD
Thrichomys pachyurus	LC
Thryonomys gregorianus	LC
Thryonomys swinderianus	LC
Thylamys cinderella	LC
Thylamys citellus	LC
Thylamys elegans	LC
Thylamys fenestrae	NT
Thylamys karimii	VU
Thylamys macrurus	NT
Thylamys pallidior	LC
Thylamys pulchellus	LC
Thylamys pusillus	LC
Thylamys tatei	DD
Thylamys velutinus	NT
Thylamys venustus	DD
Thylogale billardierii	LC
Thylogale browni	VU
Thylogale brunii	VU
Thylogale calabyi	EN
Thylogale lanatus	EN
Thylogale stigmatica	LC
Thylogale thetis	LC
Thyroptera devivoi	DD
Thyroptera discifera	LC
Thyroptera lavali	DD
Thyroptera tricolor	LC
Thyroptera wynneae	DD
Tlacuatzin canescens	LC
Tokudaia muenninki	CR
Tokudaia osimensis	EN
Tokudaia tokunoshimensis	EN
Tolypeutes matacus	NT
Tolypeutes tricinctus	VU
Tomopeas ravus	EN
Tonatia bidens	DD
Tonatia saurophila	LC
Tonkinomys daovantieni	DD
Toromys grandis	LC
Toromys rhipidurus	DD
Trachops cirrhosus	LC
Trachypithecus auratus	VU
Trachypithecus barbei	DD
Trachypithecus cristatus	NT
Trachypithecus delacouri	CR
Trachypithecus francoisi	EN
Trachypithecus geei	EN
Trachypithecus germaini	EN
Trachypithecus hatinhensis	EN
Trachypithecus johnii	VU
Trachypithecus laotum	VU
Trachypithecus obscurus	NT
Trachypithecus phayrei	EN
Trachypithecus pileatus	VU
Trachypithecus poliocephalus	CR
Trachypithecus shortridgei	EN
Trachypithecus vetulus	EN
Tragelaphus angasii	LC
Tragelaphus buxtoni	EN
Tragelaphus derbianus	VU
Tragelaphus eurycerus	NT
Tragelaphus imberbis	NT
Tragelaphus oryx	LC
Tragelaphus scriptus	LC
Tragelaphus spekii	LC
Tragelaphus strepsiceros	LC
Tragulus javanicus	DD
Tragulus kanchil	LC
Tragulus napu	LC
Tragulus nigricans	EN
Tragulus versicolor	DD
Tragulus williamsoni	DD
Transandinomys bolivaris	LC
Transandinomys talamancae	LC
Tremarctos ornatus	VU
Triaenops afer	LC
Triaenops parvus	DD
Triaenops persicus	LC
Triaenops rufus	LC
Trichechus inunguis	VU
Trichechus manatus	VU
Trichechus senegalensis	VU
Trichosurus caninus	LC
Trichosurus cunninghami	LC
Trichosurus vulpecula	LC
Trichys fasciculata	LC
Trinomys albispinus	LC
Trinomys dimidiatus	LC
Trinomys eliasi	NT
Trinomys gratiosus	LC
Trinomys iheringi	LC
Trinomys mirapitanga	DD
Trinomys moojeni	EN
Trinomys paratus	DD
Trinomys setosus	LC
Trinomys yonenagae	EN
Trinycteris nicefori	LC
Trogopterus xanthipes	NT
Tryphomys adustus	DD
Tscherskia triton	LC
Tupaia belangeri	LC
Tupaia chrysogaster	VU
Tupaia discolor	DD
Tupaia dorsalis	DD
Tupaia everetti	LC
Tupaia ferruginea	DD
Tupaia glis	LC
Tupaia gracilis	LC
Tupaia hypochrysa	DD
Tupaia javanica	LC
Tupaia longipes	LC
Tupaia minor	LC
Tupaia montana	LC
Tupaia nicobarica	EN
Tupaia palawanensis	LC
Tupaia picta	LC
Tupaia salatana	LC
Tupaia splendidula	LC
Tupaia tana	LC
Tursiops aduncus	DD
Tursiops truncatus	LC
Tursiops truncatus	LC
Tursiops truncatus	LC
Tylomys bullaris	CR
Tylomys fulviventer	DD
Tylomys mirae	LC
Tylomys nudicaudus	LC
Tylomys panamensis	DD
Tylomys tumbalensis	CR
Tylomys watsoni	LC
Tylonycteris pachypus	LC
Tylonycteris robustula	LC
Tympanoctomys aureus	CR
Tympanoctomys barrerae	NT
Tympanoctomys kirchnerorum	DD
Tympanoctomys loschalchalerosorum	CR
Typhlomys cinereus	LC
Uranomys ruddi	LC
Urocitellus armatus	LC
Urocitellus beldingi	LC
Urocitellus brunneus	CR
Urocitellus canus	LC
Urocitellus columbianus	LC
Urocitellus elegans	LC
Urocitellus endemicus	VU
Urocitellus mollis	LC
Urocitellus parryii	LC
Urocitellus richardsonii	LC
Urocitellus townsendii	VU
Urocitellus undulatus	LC
Urocitellus washingtoni	NT
Urocyon cinereoargenteus	LC
Urocyon littoralis	NT
Uroderma bilobatum	LC
Uroderma magnirostrum	LC
Uromys anak	LC
Uromys boeadii	CR
Uromys caudimaculatus	LC
Uromys emmae	CR
Uromys hadrourus	NT
Uromys imperator	CR
Uromys neobritannicus	NT
Uromys porculus	CR
Uromys rex	EN
Uromys siebersi	DD
Uromys vika	CR
Uropsilus andersoni	DD
Uropsilus gracilis	LC
Uropsilus investigator	DD
Uropsilus soricipes	LC
Urotrichus talpoides	LC
Ursus americanus	LC
Ursus arctos	LC
Ursus maritimus	VU
Ursus thibetanus	VU
Vampyressa melissa	VU
Vampyressa pusilla	DD
Vampyressa thyone	LC
Vampyriscus bidens	LC
Vampyriscus brocki	LC
Vampyriscus nymphaea	LC
Vampyrodes caraccioli	LC
Vampyrodes major	LC
Vampyrum spectrum	NT
Vandeleuria nilagirica	EN
Vandeleuria nolthenii	EN
Vandeleuria oleracea	LC
Varecia rubra	CR
Varecia variegata	CR
Vernaya fulva	LC
Vespadelus baverstocki	LC
Vespadelus caurinus	LC
Vespadelus darlingtoni	LC
Vespadelus douglasorum	LC
Vespadelus finlaysoni	LC
Vespadelus pumilus	LC
Vespadelus regulus	LC
Vespadelus troughtoni	LC
Vespadelus vulturnus	LC
Vespertilio murinus	LC
Vespertilio sinensis	LC
Vicugna vicugna	LC
Viverra civettina	CR
Viverra megaspila	EN
Viverra tangalunga	LC
Viverra zibetha	LC
Viverricula indica	LC
Voalavo antsahabensis	EN
Voalavo gymnocaudus	LC
Volemys millicens	NT
Volemys musseri	DD
Vombatus ursinus	LC
Vormela peregusna	VU
Vulpes bengalensis	LC
Vulpes cana	LC
Vulpes chama	LC
Vulpes corsac	LC
Vulpes ferrilata	LC
Vulpes lagopus	LC
Vulpes macrotis	LC
Vulpes pallida	LC
Vulpes rueppellii	LC
Vulpes velox	LC
Vulpes vulpes	LC
Vulpes zerda	LC
Waiomys mamasae	DD
Wallabia bicolor	LC
Wiedomys cerradensis	DD
Wiedomys pyrrhorhinos	LC
Wilfredomys oenax	EN
Wyulda squamicaudata	NT
Xenomys nelsoni	EN
Xenuromys barbatus	LC
Xeromys myoides	VU
Xeronycteris vieirai	DD
Xerospermophilus mohavensis	NT
Xerospermophilus perotensis	EN
Xerospermophilus spilosoma	LC
Xerospermophilus tereticaudus	LC
Xerus erythropus	LC
Xerus inauris	LC
Xerus princeps	LC
Xerus rutilus	LC
Zaedyus pichiy	NT
Zaglossus attenboroughi	CR
Zaglossus bartoni	VU
Zaglossus bruijnii	CR
Zalophus californianus	LC
Zalophus wollebaeki	EN
Zapus hudsonius	LC
Zapus princeps	LC
Zapus trinotatus	LC
Zelotomys hildegardeae	LC
Zelotomys woosnami	LC
Zenkerella insignis	LC
Ziphius cavirostris	LC
Ziphius cavirostris	LC
Zygodontomys brevicauda	LC
Zygodontomys brunneus	LC
Zygogeomys trichopus	EN
Zyzomys argurus	LC
Zyzomys maini	VU
Zyzomys palatalis	CR
Zyzomys pedunculatus	CR
Zyzomys woodwardi	LC
